reference	hypA	hypB	annotation
ce soir sur lcp avec le meeting de philippe poutou à la halle carpentier à paris	euh ce soir sur euh lcp avec le meeting de philippe poutou a la ale carpentier à paris	euh ce soir sur euh lcp avec le meeting de philippe poutou à la al carpentier à paris	0
en fait le le le la rumeur l' information de sa maladie commençait à courir les rédactions	en fait le le le renard l' information ani commencent à courir des rédactions	euh enfin le le le le le le la rumeur l' information de travail commence à courer les rédactions	0
ça vaut pas cinquante centimes non c' est pas ça	pas cinqante brondimaihen c' est pas ça	n ba vrai quant en dit maion c' est pas ça	1
c' est je leur ai demandé s' ils sont prêts de le faire ils l' ont fait	je leur ai demandé s' ils sont près de le faire ils ont fait	c s je leur ai demandé s' ils sont prêts de le faire ils l' ont fait	0
s' il est question de l' autorité de la france la question de sa de sa de sa potentialité	si la question de l' autorité de la france la question de sa toutes ses potentialités	si la question de l' autorité de la france la question de de ça ça peut se potentialités	1
le problème du pouvoir d' achat des familles	le problème euh du pouvoir d' achat des familles	problème du pouvoir d' achat des famille	1
bon un peu oui mais bon	bon j' étais juqu' il es là c' est ça ou ou un peu oui mais bon	bon c' était juste' il est ail c' est ça ou ou un peu oui mais bon	1
le nouveau président ne composait pas un gouvernement il recrutait dit elle pour un casting	le nouveau président de composer pas un gouvernement il recrutait dit elle pour un casting	le nouveau président ne composait pas un gouvernement il le recrutait dit-elle pour un casting	0
debriefing et stratégie ont été définis par les cadres lors du dernier conseil national	euh des brifings et stratégies ont été définis par les cadres lors du dernier conseil national	euh des brifiques et stratégies ont été définis par les cadres lors du dernier conseil national	1
décortiquons cher christophe bonjour	décortiant jeanqueschristophe bonjour	décortiqant jacques-christophe bonjour	0
depuis le début de l' année l' île	depuis le début de l' année lille	depuis le début de l' année l îlle	0
entre jean louis debré et nicolas sarkozy ils se sont croisés tous les deux	entre jean-louis debré et nicolas sarkozy se sont croisés tous les deux	entre jean-louis debré nicolas sarkozy se sont croisés tous les deux	1
j' ai regardé partout en me disant quoi il s' est vraiment passé des choses incroyables	gère cardié partout en disant quoi hein il s' est vraiment passé des choses incroyables	regardez partout en me disant court c' est vraiment passé des choses incroyables	1
que sur des mesures d' austérité certes elles sont nécessaires ça vient d' être dit mais il faut aussi	que sur des mesures d' austérité certaines sont nécessaires euh ça vient d' être dit mais il faut aussi euh	que sur des mesures d' austérité certes elles sont nécessaires euh ça vient d' être dit mais il faut aussi euh	0
je préviens le bourget pour leur dire qu' on risque de décoller en retard	près d' un projet pour leur dire qu' on risque de découverte	je crois quand même un projet pour leur dire qu' on risque de d	1
énerve tout le monde	monarve tout lemonde	ar tout le monde	1
je vous en prie le président vous attend	j'' ai vous en prix le président vous attend	puis vous en prix lu président vous attend	1
je représente la gauche raisonnable	je représsante la gauche raisonnable	jees représente la gauche raisonnable	1
vous vous et vous vous aimez la cuisine vous êtes vous coulée dans ce rôle très facilement	vous vous aiz) vous vous aimez la cuisine vous êtes euh coulé dans ce rôle euh très facilement	vous et vous aimez la cuisine vous êtes dans ce rôle très facilement	1
et oui objectif protester contre mille quatre cents suppressions de postes annoncées alors que	ah oui objectif protester contre mille quatre cents suppressions de postes annoncées alors que	eh oui objectif protester contre mille quatre cents suppressions de postes annoncés alors que	0
c' est pas c' est pas ce que je dirais bien évidemment	c' est pas parce que je dirais bien évidemment	ce qui me paraît ce n' est pas ce que je dirai bien évidemment	0
pas de scénario à la grecque	pas de scénario à la grève	scénario à la grecque	0
décortiquons cher christophe bonjour	décortiquant jacqueschristophe bonjour	des corticans jacques christophe bonjour	1
elle pourrait rentrer dans un gouvernement ps	elle pourrait rentrer dans un gouvernement je	elle pour rait rentrer dans un gouver e men e le ens ens pa	1
pas de scénario à la grecque	scénario à la grecque	pas de scénario à la grève	1
sa capacité de protéger les plus faibles c' est à dire et nous sommes	capacité de protéger les plus faibles c' est à dire et nous sommes	sa capacité de protéger les plus faibles c' est-à-dire et nous sommes	0
à dix neuf heures trente dans une petite heure maintenant william and kate avec la flamme à buckingham palace	à dix-neuf heures trente dans une petite heure maintenant william ankeitt avec la flamme à bukingham palace	a dix neuf heures trente dans une petite heure maintenant william nk7 avec la flamme à buckingham palace	1
là nous baissons cela à cent mille euros c' est déjà quand même assez significatif cent mille euros	là nous baissons cela à cent milles euros ce qui est déjà quand même assez significatif cent milles euros	là nous baissons cela cent milles euros ce qui est déjà comme assez significatif cent mille euros	1
qu' est ce qu' ils ont défendu les classes les plus riches	est ce qu' ils ont défendu les classes les plus riches	qu' est-ce qu' ils ont défendu les classes les plus riches	0
d' un mur des cons	un mur déco	d' un mur des ca	0
ça n' est pas la réalité	ce n' est pas la réalité	n' est pas la réalité	1
deux tiers de page pour toi un tiers pour hollande le seul à pouvoir gagner	deuxième dopage pourquoi un tiers pour eux important que monsieur grand galière	deux tirs de opage pourtoi un tir pour euh en europe de se la ve ra galiè	1
la reprise par alexandre pougatchev notre franco russe	euh la reprise par euh alexandre pugacchev notre franco russe	euh la reprise par euh alexandre pougatschev notre franco-russe	0
rendant hommage à ces juifs morts c' est c' est quand même extraordinaire	rendant hommage à ces juifs mortsc' c' est quand même extraordinaire	rendant hommage à ces juifs morts c c' est quand même extraordinaire	0
davantage au cortex qu' aux tripes	davantage au corps texcotrique	davantage au ctexteco trique	1
moi ce que je vous propose c' est que on ait un bref un bref tour	ce que je vous propose c' est que on est un bref euh à bref tour	ce que je vous propose c' est que on ait un bref euhhm un bref tour	0
faire du voyeurisme	du voyaux risme	qand vous voyons risou	1
en bref la situation en syrie les combats se sont poursuivis aujourd'hui à alep	en bref la situation en syrie les combats se sont poursuivis aujourd' hui à albep	en bref la situation en syrie les combats se sont poursuivis aujourd' hui à aleb	1
je pense que y a énormément de français qui dans les derniers jours là vont avoir envie de s' exprimer	je pense qu' il y a énormément de français qui dans les derniers jours là vont avoir envie de s' exprimer	je pense qu' énormément de français qui dans les derniers jours là vont avoir envie de s' exprimer	1
c' était le mouvement de résistance défense de la france	euh c' était le mouvement de réxistence défensef de la france	euh c' était le mouvement de résistance défense de( de la france	0
on disait c' est une marque vieillissante un peu datée ils font des voitures maintenant formidable la ds3 la ds4	euh on disait c' est une marque vieillissante un peu datée ils font des voitures maintenant formidables la ds trois la ds quatre	euh on disait c' est une marque vieillisseante un peu datée il font des voitures maintenant formidable la dstroi à la dsk	1
dit maintenant ok je mets je remets les pendules à l' heure et c' est nécessaire	duit maintenant ok je mets je remets les pendules à l' heur et c' était nécessaire	dit maintenant e que je met je remets les pendue à l' heure et c' est nécessaire	1
rapport de la cour des comptes il y a aucun doute si c' est cinq cents milliards	rapport de la cour des comptes il y a aucun doute si c' est ça sont mia	apport de la cour des comptes il y a aucun doute si c' est cinq cents milliard	0
ça a rattrapé ça a retrouvé les dizaines de fois où il a toujours été comme ça	euh ça a atttrapé ça a retrouvé les dizaines de fois elle a toujours été comme ça	euh ça a rattrapé ça a retrouvé les dizaines de faux il a toujours été comme ça	1
par le passé un certain nombre de boycott d' ailleurs	euh par le passé un certain nombre de boycott d' ailleurs	euh par le passé nun certain nombre de boycott d' ailleurs	1
vous êtes décidemment obsédés par françois fillon ou jean françois copé	et décidément obsédé par françois fillon ou jean françois copé	vous tes décidément obsédé par françois fillon et jean-f françois copé	0
claude vous voulez me parler de	claude vous voulez parlez de de	claude vous les me parlez de de	1
qu' est ce qu' ils ont défendu les classes les plus riches	et ce qu' ils ont défendu les classes les plus riches	qu' est-ce qu ils ont défendu les classes les plus riches	0
après la remontée de nicolas sarkozy au moment de l' affaire merah	euh après la remontée de nicolas sarkozy au moment de l' affermera	euh après la remontée de nicolas sarkozy au moment de l' a fermera	1
ça leur fait un coup de pub très intéressant	ça leur fait un coup de pube très intéressant	ça leur fait un coup de pub très intéressan	0
alors j' ai entendu un peu la démagogie sur les collectivités vous savez sur les	j' ai entendu un peu la démagogie sur les collectivités sur les	alors j' ai entendu un peu la démagogie sur les collectivités euh sur les euh	1
les plus pénalisés et puis autour de de cela et au delà même sur les sur les fonctionnaires	plus pénalisés et puis au autour de de de cela et au delà même sur les sur les fonctionnaires	les plus pénalisés et puis au autour de de de cela et au-delà même sur les sur les fonctionnaires	0
il faisait quelque chose que j' avais jamais vu avant	et i(l) faisait quelque chose que j' avais jamais vu avant	est quelque chose que j' avais jamais vu avant	1
je crois qu' il reste en tout cas une référence pour beaucoup d' entre nous au sein de l' ump	euh je crois qu' il reste en tout cas une référence pour beaucoup d' entre nous euh au sein euh de l' ump	je crois qu' i(l) reste en tout cas une référence pour beaucoup d' entre nous euh au sein de l' ump	0
les thèmes s' enchaînent emploi comptes publics éducation ou encore immigration	thème s' enchaînent emploi comptes publics éducation ou encore immigration	les thèmes s' enchaînent emploi compte public éducation ou encore immigration	0
oui alors c' est c' est un peu l' avenir	oui alors euh euh c'est c' est un peu l' avenir	oui alors euh euh c' est c' est un peu l' avenir	0
le le le type de risque et l' échelle des hypothèses en matière de dangerosité est extrême et extrêmement large	le le je ire le le le type de risque et l' échelle des hypothèses en matière de dangerosité est extrême et extrêmement euh large	le je e dir le le type de risque et l' échelle des hypothèses en matière de dangerosité est extrême et extrêmement euh large	1
c' est vrai que y a beaucoup d' attente donc on déconseille aux sportifs qui	euh c' est vrai qu' il y a beaucoup d' attentees donc ont des conseils au sportifs qui	euh c' est vrai qu' y a beaucoup d' attentes donc ont des conseils au sportifs qui	0
l' analyse que vous en faites et les conséquences que le gouvernement français compte en tirer	analyse que vous en faites et les conséquences que le gouvernement français compte en tirer	l' analyse que vous en faites est les conséquences que le gouvernement français compte en tirer	1
patrick bloche on vous l' avait promis vous venez de l' avoir merci grand merci à tous les deux	quand vous l' avez promis vous venez de la voir merci grand merci à tous les deux	(tricqu brofh on vous l' avez promis vous venez de l' avoir merci grand merci à tous les deux	0
l' actualité aujourd'hui ce sont également les européens mobilisés contre l' austérité	l' actualité aujourd' hui ce sont également les européens mobilisés contre l' austérité	l' actualité aujourd' hui ce sont également les européens mobilisés contre l' auscérité	1
moi quand j' étais à valeurs actuelles nicolas sarkozy ne nous voyait pas donc	moi candidat à l' heure actuelle euh nicola sarkozy ne nous voyait pas donc euh	moi qu' en littéral l' heutre actuelle euh nicolas sarkozy ne nous voyaiez pas donc euh	1
ça elle l' a dit	l' a dit euh	ça elle l' a dit euh	0
et plus surprenant lady gaga	et plus surprenant laydy gaga	est plus surprenant e lai di daga	1
je prends juste l' exemple de ma région la haute normandie on a encore deux régions haute normandie basse normandie	je prends juste l' exemple de ma région la hautenormandie on a encore deux régions hnorment dit bassenormandie	je prends juste l' exemple de ma région la haute normendie on a encore deux régions autremen dit basse-normandie	1
peuvent ils considérer que c' est un risque	peuve-t-il considérer que c' est un risque	peuvent-ils considérer que c' est un risque	0
se trouver avec des taux d' intérêt italiens ou espagnols qui va qui va tomber la	se trouver avec des taux d' intérêt italiens ou espagnols qui va qui va qa tomber la	se trouver avec des taux d' intérêt italiens ou espagnols qui va qui va faire tomber la	1
j' ai regardé partout en me disant quoi il s' est vraiment passé des choses incroyables	j' i regardez partout en me disant quoire il c' est vraiment passé des choses incroyables	j' ai regardé partout en me disant quo et c' est vraiment passé des choses incroyables	0
a totalement raison c' est que cet accord portera vraiment ses fruits en période de de	raison c' est que cet accord portera vraiment ses fruits en période de deux ans	non c' est que cet accord portera vraiment ses fruits en période de deux	1
une lutte qui semble impossible car l' italie de stefano sollima est une italie en pleine crise morale	une lutte qui semble impossible carlitali de stéphane o solima et tunitalie en cleine crise morale	une lutte qui semble impossible car l' italie de stéphane o solima est une italie en cleine crise morale	0
pas de mobilisation véritablement là on voit comment ça peut ça peut prendre	une fois de mobilisation véritablement là on voit comment euh ça peut euh ça peut prendre	en)fin de mobilisation véritablement là on voit comment euh ça peut euh ça peut prendre	1
sarkozy et on a limite quoi qu' il dise actuellement ça ne passe pas sauf ceux naturellement qui sont	sarkozy y e en alimique quoi qu' il dise actuellement ça ne passe pas sous se naturlement qui sont	sarkozy y an en a limite quoi qu' ils disent actuellement ça ne passe pas souss naturellement qui sont	0
johnny en mode bisous applaudi par la foule johnny en mode ray charles public attentif	johny en mode bizoul applaudi par la foule johny en modrait charles public attentif	johnny en mode bizou applaudie par la foule tony en modry charls publique attentif	1
que fait il dénoncer les uns ça ne donne pas de solutions pour les salariés créer cette tension	que fait-il dénoncer les uns ça ne donne pas des solutions pour les salariés euh créer euh cette tension	fait il dénoncer les ans ça ne donne pas des solutions pour les salariés créer cette tension	1
pour la moralisation de la vie politique aura été condamné en diffamation pour avoir	euh euh pour la moralisation de la vie politique aura été condamné en diffamation pour avoir	euh pour la moralisation de la vie politique aura été condamnée en diffamation pour avoir	0
formation professionnelle c' est un des points	professionnel c' est un des points	le prouvent seule c' est un des points	1
sur la fin sur la fin	par la fi sur la fin	la fin sur la fin	0
interdiction également de poster les résultats d' une compétition ou encore de partager les vidéos	interdiction également de poster les résultats d' une compétition ou encore de partager des vidéos	interdiction également de poster les résultats d' une compétition ou encore de partager les vidéo	0
c' était on le présente aujourd'hui comme l' un des meilleurs animateurs radio et télé de sa génération malheureusement	c' était on le présente aujourd' hui comme l' un des meilleurs animateurs radio est élé de sa génération malheureusement	c' était on le présente aujourd' hui comme un des meilleurs animateurs radios et télé de sa génération malheureusement	0
ça va alors ça y est vous êtes prête	ui va lorvsalez vous êtes prêt	va bon ça allez vous être pr	0
crier aussi leur espérance	aussi leur espérance	cer aussi leur espérance	1
entre monsieur lakshmi mittal	entre monsieur lachemi mittal	monsieur lakshmi mittal	1
dans le quinquennat précédent donc vous voyez	le quinquennat précédent dont vous voyez	dans le quinquennat u précédent donc vous voyez euh	0
comment il s' appelle	apple	il s' appelle	0
ces réformes structurelles vous les abandonnez personnellement je le regrette beaucoup	ces réformes structurelles vous les abandonnes personnellement je le regrette beaucoup	ces réformes structurelles vous les abandonner personnellement je le regrette beaucoup	0
tu peux me rappeler ou pas	tu peux me rattrape pas	tu peux me rabat tout pas	1
sur la tyrannie de l' émotion	c' est la puramie de l' émotion	c' est la turannie de l' émotion	0
il avait c' était un énorme bosseur jean luc il faut il faut pas oublier ça il était	vous savez c' est un énorme boxeur jean louis qui faut il ne faut pas oublier ça il était	avez vous c' est un énorme bosphore jean louis qu' il faut il faut pas oublier ça il était	1
un sabotage insupportable	sabotage insupportable	un sabotage euh insupportable	0
alors ronald du côté de l' organisation y a il y a t il encore quelques points noirs à régler	euh ronald du côté de l' organisation il y a y a-t-il encore quelques points noirs à régler	euh ren aldes du côté de l' organisation y a y a-t-il encore quelques points noirs à régler	1
où se réunissent ce soir et demain l' association des des amis de nicolas sarkozy	où se réunissent ce soir et demain l' association des des amis nicolas sarkozy	se réunissent ce soir et demain l' association des des amis de nicolas sarkozy	1
il me manque une direction	qu' une direction	il m' manque une direction	0
qui existe beaucoup moins aujourd'hui en tout cas qui n' est plus en première ligne	qui existe beaucoup moins aujourd' hui en tout cas qu' il n' est plus en première ligne	qui existe beaucoup moins aujourd' hui en tout cas qu'il n' est plus en première ligne	0
il y avait pas ces soucis avant	' est pas c' est fa usi avant	est c' est le souci avant	0
des éditions hugo et compagnie et puis avec vous avec nous virgile caillet bonsoir vous êtes directeur de kantarsport	éditions hugo et compagnie et puis avec vous vous avec nous virgile caillet bonsoir vous êtes euh directeur de cantar sport	éditions hugo et compagnie et puis avec vou() vous e avec nous virgile caillet bonsoir vous êtes euh directeur de cantar sport	1
pour pour lui pour nous et un moment très très agréable	pour euh pour lui pour nous et un moment très très agréable	poureuh pour lui pour nous et un moment très très agréable	0.5
à condition aussi que ces hommes que l' armée utilise ces armes	condition aussi que euh ces hommes que l' armée euh euh utilise ces armes	aussi que ces hommes que l' armée utilisent ces armes	1
attendez est ce qu' on peut juste parler des faits	bais attendez est-ce qu' on peut juste parler des	attendez est-ce qu' on peut juste parler des f)	0
en quelque sorte assigné à résidence à l' hôtel de la gazelle d' or à taroudant	quelque sorte assigné à résidence à l' hôtel de la gazelle d' or à taroudant	en quelque sorte a signé à résidence à l' hôtel de la gazelle d' or à tarroudan	1
vous allez nous citer gerhard schröder	vous allez nous cituer euh gerhard schröder	vous allez nous situer euh gerhard schröder	1
si c' est	je suisse	si	0
bon fin des citations	i enfin de la itation)	por fin de cissation	0
l' émotion du choc est un peu un peu redescendue et	qui est un peu un peu tendu et hum	l' émotion euh plus choc et un veu un peu en descendu et euh	0
là en plus il fait des il fait des sorties qui sont pas genre rassembleuse	là en plus i(l) fait des il fait des sorties qui sont pas euh j' en rassembleuses euh	là en plus i(l) fait des i(l) fait des sorties qui sont pas euh gen(s rassembleuses euh	1
programmé pour ça de de par ces longues années au parti socialiste et	programmée pour ça de de par ses longues années au parti socialiste et	programmé pour ça de d( par ces longues années au parti socialiste et	1
dans la salle plus de deux mille militants conquis et des proches aussi après l' avoir souvent critiquée	la salle plus de deux mille militants conquis et des proches aussi après l' avoir souvent critiqué	dans la salle plus de deux milles militants complies et des proches aussi après l' avoir souvent critiqué	1
pour la russie comme pour la france	pour la russie internationale	pour la rssi comme pour le o	1
le nouveau président ne composait pas un gouvernement il recrutait dit elle pour un casting	le nouveau président ne composait pas un gouvernement il le recrutait dit-elle pour un casting	le nouveau président de composer pas un gouvernement il recrutait dit elle pour un casting	1
c' est comme ça que vous le voyez	comme ça vous le voyez euh	c' est comme ça que vous le voyez euh	0
qui avait rassemblé plus de vingt millions de personnes jean baptiste prédali bonjour	avait rassemblé plus de vingt millions de personnes jean baptiste prédali bonjour	qui avait rassemblé plus de vingt millions de personnes jean-baptiste prédali bonjour	0
aimons nous les uns les autres construisons ensemble	aimons nous les uns les autres conscuisons ensemble	aimons-nous les uns les autres consrusons ensemble	0
c' était tout à fait légal de de de vendre lorsqu' on était une entreprise française du matériel	c' était tout à fait légal de de de vendre euh lorsqu' on était une entreprise française du matériel	eu c' était tout à fait légal de de de vendre euh lorsqu' on était une entreprise française du matériel	1
le prix sang neuf est décerné cette année à stefano sollima	prix sang neuf est décerné cette année pas des panneaux solaires	le prix cent neuf est décerné cette année a stéphano solivar	0
le chiffre était	le chez côté	le chef fout de e	1
mais ce coup de sécateur était imbécile	mais ce coûp de sécateur était un	coûte sécateur été	1
de sa grand mère ça c' est vraiment c' est c' était ses mots	de sa grand-mère ça c' est vraiment ce c' était ces mots	c' est sa grand-mère ça c' est vraiment c' est c' était ses mots	0
la compagnie veut proposer des incitations financières à ses pilotes pour les faire travailler au sein de sa filiale transavia	la compagnie veut euh proposer des incitations financières à ces pilotes pour les faire travailler au sein de sa filiale transavia	la compagnie veut euh proposer les incitations financières à ses pilotes pour les faire travailler au sein de sa filiale transabia	1
vous êtes directeur de l' institut des sciences de la communication du cnrs spécialiste des médias	vous êtes directeur de l' institut des sciences de la communication du cnrs spécialiste euh des médias	vous êtes euh directeur de l' institut des sciences de la communication du cnrs spécialiste des médias	0
ce ce cette déclaration tout à fait positive	cette déclaration tout à fait positive	ce ce cette déclaration euh tout à fait positive	1
daniel fasquelle est ce que vous reconnaissez quand même qu' à l' ump vous êtes partagés sur cette question	daniel fascal est-ce que vous reconnaissez quand même qu' à l' ump vous êtes partagée sur cette question	danièle fascal est-ce que vous reconnaissez quand même qu' à l' ump vous êtes partagé sur cette question	0
dans le quinquennat précédent donc vous voyez	dans le quinquennait euh précédent donc vous voyez euh	le quinquennat précédent dont vous voyez	1
une forme de protectionnisme européen sur les produits venus de l' extérieur	de protectionnisme européen sur les produits laitiers	forme de proteionnis fonds européen sur les produitsri	1
donc tout d' un coup il descendait de l' olympe si vous voulez voilà donc il descendait de l' olympe	donc euh tout d' un coup il descend des blaulins c' est l' autorité on prend souvent donc il descendait de là	donc euh tout d' un coup il descendait de l' olympe si vous tournez il ça voilà donc il descendait de l' olympympe	0
avec pugnacité marie labat	avec pugnacité marie laban	avec pugnacité marie-labet	0
comme le sont aujourd'hui les états c' est un	comme le sont aujourd' hui les états c' est un	comme le sont aujourd' hui les etats c' est un	1
infléchi ou est ce qu' il a	infléchit ou est-ce qu' il a	infléchi ou est-ce qu' il a	0
c' est difficile quand on augmente davantage les dépenses	c' est difficile dont on augoerse davantage les dépensees)	c' est difficile dont on augmente d avantage les dépenses	0
vous êtes directeur de l' institut des sciences de la communication du cnrs spécialiste des médias	vous êtes euh directeur de l' institut des sciences de la communication du cnrs spécialiste des médias	vous êtes directeur de l' institut des sciences de la communication du cnrs spécialiste euh des médias	1
où y a l' ambiance très agréable	oui il y a une ambiance très agréable	où il y a une ambiance euh très agréable	1
on parle beaucoup aussi bien sûr de laure manaudou	parle beaucoup aussi bien sûr de laure manaudou	on parle beaucoup aussi bien sûr de l'aure manoudu	1
après la remontée de nicolas sarkozy au moment de l' affaire merah	euh après la remontée de nicolas sarkozy ou lon on ne la fermera	euh après la remontée de nicolas sarkozy au moment de l' affaire mera	0
et cette affaire date de de la fin deux mille onze	ui cette affaire date de de la fin deux milles onze	et cette affaire date de de la fin deux milles onze	0
sur le fait est ce que j' aurais souhaité que nicolas hulot reste avec nous	sur le fait est-ce que j' aurais souhaité que nicolas hulorest avec nous	sur le fait est-ce que j' aurais souhaité que nicolas hulot reste avec nous	0
françois bayrou nous prédit un destin à l' espagnol en renvoyant françois hollande et nicolas sarkozy dos à dos	françois bayrou nous prédit un destin à l' espagnol en renvoyant françois hollande et nicolas sarkozy dos a do	françois bayrou nous prédit un destin à l' espagnol en renvoyant françois hollande et nicolas sarkozy dos ado	1
du dernier adieu à whitney houston	du dernier adieu à witmey ouston	dernier adieu à whitney houston	0
que vous ne l' ayez pas mais je le pose aux cliniques privées	n' ayez pas mais je pose aux cliniques privées	que vous ne l' yiez pas mais je le pose aux clinigues privé	0
et puis de toute façon roger moore qu' on se le dise il a quelque chose en plus	et puis de toute façon roger mour qu' on se le dise il a quelque chose en plus	et puis toute façon roger mour qu' on se le dise il a quelque chose en plus	1
priorité nous sommes nous sommes	priorité nous sommesan nous sommes	priori ça ne vous allez en choisissant m	1
manuel valls il y pense par exemple pour	manuel valls l' y pense par exemple pour	manuel vall ça ne di pense par exemple eonpou	1
les bourses européennes restent stables ou en légère baisse	bourses européennes reste stable ou en légère baisse	les bourses européennes restent stables ont légère baissent	1
mais dans les jeux olympiques y a pas de logique	mais dans les jeux olympiques l y a pas de logique	mais dans les jeux olympiques il y a pas de logique	0
alors jean marie le guen	jean marie le bouche	alors-marie le guen	0
quand même pas ils sont venus me voir il y a trois semaines	ils sont venus mais voir il y a trois semaines	o canm ba ils sont venus me voir il y a trois semaines	1
ça ça les a bouleversés et ils voulaient montrer ils voulaient faire un geste symbolique	ça ça les a bouleversé et il voulait montrer vous voulait faire un geste symbolique	ça ça les a bouleversés et il vouslait montrer voulait faire un geste symbolique	1
exactement d' ailleurs vous avez le leader le le président des pigeons entre guillemets qui est au premier rang	d' ailleurs vous avez le leader le le le président des pigeons entre guillemets qui est au premier rang	exactement d' ailleurs vous avez le leader euh le le le président des pigeon entre guillemets qui est au premier rang	1
alors pourquoi valéry giscard d' estaing vote nicolas sarkozy	alors pourquoi valéry giscard d' estaing votre nicolas sarkozy	alors pourquoi valéri giscard d' estaing vote nicolas sarkozy	0
non mais parlons des recettes nouvelles que	mais parlons des recettes nouvelles que	euh non mais parlons des recettes nouvelles que	0
qui fait son retour dans des jeux olympiques très discrète très pressée visiblement laure manaudou puisqu' elle a évité quasiment	euh qui fait son retour euh dans des jeux olympiques et très discrètes très pressés visiblement leur malaudou euh puisqu' elle a invité quasimen	euh qui fait son retour dans des jeux olympiques très discrète très pressée visiblement leur malaudou et puisqu' elle a évité quasiment	0
maxime poullaouec est il avec nous pour les infos trafic	maxime pour la ouedec est il avec nous pour les infos trafic	maxime poulawec est-il avec nous pour les infos trafics	0
mais de quoi s' agit il sa directrice est mon invitée dans bfm story	mais de quoi s' agit-il sa directrice et mon invité dans bfm story	de quoi s' agit il sa directrice et mon invitée dans bfm story	1
un grand rassemblement de l' unité nationale	un grand rassemblement de l' unité bon national et c' est un	un grand rassemblement de l' unité bon nationaleet cetuni	1
ils me l' ont dit	le melon	il me l' ont dit	0
ses failles et et parfois justement ce que ça pouvait avoir de	euh s' éfaillent et euh et parfois justement ce que ça pouvait avoir de enmer gural	ces failles et et parfois justement ce que ça pouvait avoir de mal	0
mais c' est vos	mais c' est vous	mais c' est veau(	0
qui pensent qu' il faut choisir pour les pour la population obtue pour les peuples obtus	qui pensent qu' il faut choisir pour les pour la population obtue pour les peuples optus	qui pensen qu' il faut choisir pour les pour la population otue pour les peuples obtus	1
est avancé chez les socialistes comme premier premier ministre possible de françois hollande bien sûr s' il est élu	est avancé chez le socialiste comme premier pr() p) euh premier ministre possible de françois hollande bien sûr s' il est élu	est avancé chez les socialistes comme premier pr() pre() euh premier ministre possible de françois hollande bien sûr s' il est élu	0
c' est quoi aujourd'hui de pouvoir être accompagné dans leur financement on va le faire avec la bpi	c' est quoi ( aujourd' hui de pouvoir être accompagné dans leur financement on va le faire avec la bpi	c' est quoi (aujourd' hui de pouvoir être accompagné dans leur financement on va le faire avec la bpi	0.5
selon les les critères que tout le monde respecte depuis très longtemps le cio en a choisi autrement	ah euh selon les les critères euh que tout le monde respecte depuis euh très longtemps euh le cio en a choisi autrement	ah euh selon les les critères euh que tout le monde respecte depuis euh très longtemps euh le cie en a choisi autrement	1
je représente la gauche raisonnable	je ses répressente la gauche raisonnable	jee ripressante la gauche raisonnable	0
une forme de protectionnisme européen sur les produits venus de l' extérieur	forme de prote de so oni sur européen sur les produis ou je i a	forme de protectionnissmee européens sur les produits oue e u e	0
bérénice marlohe trente trois ans qui pour camper la bond girl a imaginé	bérénice marlo trente trois ans qui pour camper la bonde gueurre l' a imaginé	mérénice marlot trente trois ans qui pour campait la bonde gueur l' a imaginé	1
demain mais pourquoi cette initiative	demain mais pourquoi cette euh initiative	mais pourquoi cette initiative	1
du terrorisme notamment le les loups solitaires	euh du terrorisme notamment euh le les lous solitaires	euh lors du terrorisme notamment euh les les loups solitaires	1
en fait le le le la rumeur l' information de sa maladie commençait à courir les rédactions	euh en fait le le le le le la rumeur l' information de tamani commence à courir les rédactions	en fait le le le la rumeur l' information al ani commence à courir les rédactions	0
et alors je vais vous dire il y a monsieur sarkozy	oui une chose monsieur sarkozy	mais alors je veux direer une chose et monsieur sarkozy parce	0
des éditions hugo et compagnie et puis avec vous avec nous virgile caillet bonsoir vous êtes directeur de kantarsport	éditions hugo et compagnie et puis avec vous vous avec nous virgiles cailyet bonsoir vous êtes eu directeur de cantarsport	d' édition hugo et compagnie et puis avec vous vous avec nous virgines caier bonsoir vous êtes le directeur de quant ar sport	1
c' était le mouvement de résistance défense de la france	c' était le mouvement de résistance des forces de la france	euh c' était le mouvement de résistance défense de de la france	0
la france n' a jamais vendu d' arme à des dictateurs	l' arme en france n' a jamais vendu d' armes à à des dictateurs	l' a() l' argent n' a jamais vendu d' arme à des dictateurs	1
la plus grosse difficulté dans notre discipline c' est les qualifications elles sont très rudes	la plus grosse difficulté dans de discipline c' est les qualifications euh elles sont très rudes	la plus grosse difficulté dans une discipline c' est les qualifications sont très rude	1
oui alors c' est c' est un peu l' avenir	oui alors euh c' est c' est un peu l' avenir	oui alors euh c'est c' est un peu l' avenir	1
pense que ça fait partie des pistes intéressantes passer d' une fiscalité qui est encore balbutiante	pense que ça fait partie des pistes intéressantes c' est une fiscalité qui est encore balbutiante	pense que ça fait partie des pistes intéressantes c' est une fiscalité qui est encore balbuchante	1
je ne berce pas mon public par des belles paroles rassurantes	je n' perséma mon public par des belles paroles rassurantes	je n' abpère que c' est pas moi public par des belles paroles rassurantes	1
oui c' est déjà la douche froide et puis et puis les records	oui c' est déjà la douche froide et puis e puis les records euh	oui c' est la douche froide et puis et puis les records	0
contre l' euro	contre le ro	l' euro	1
est ce vrai que la la sécurité fait exploser tous les budgets également	euh c' est vrai que la la sécurité fait exploser tous les budgets également	est-ce vrai que la la sécurité fait exposer tous les budgets également	0
il faut être respectueux de notre histoire et en même temps capable de se projeter dans l' avenir	i(l faut être respectueux de notre histoire et en même temps capable de se projeter dans l' avenir	il faut être respectueux de notre histoire et en même temps carnable de se procher dans l' avenir	1
nous sommes avec une spécialiste de l' espagne économiste à l' ofce danielle schweisguth	nous sommes avec une spécialiste de l' espagne économiste à l' oce danielchwis goutth	nous sommes avec une spécialiste de l' espagne économiste à l' olce danièl schwise got	0
et qui seront mis en oeuvre je n' en doute pas une seconde par la majorité parlementaire	qui seront mises en oeuvre je n' en doute pas une seconde par la majorité parlementaire	et qui seront mises en oeuvre je n' en doute pas une seconde par la majorité parlementaire	0
très très mal supporté une grand mère qui qui qu' il vénérait et enfin	euh très très mal supporté une grand-mère qui qu'i qu' il qu' il vénérait enfin	euh très très mal supporté une grand-mère qui qui qui l) qui le vénérer enfin	1
que vous ne l' ayez pas mais je le pose aux cliniques privées	que vous ne l' yiez pas mais je le pose aux cliniques privé	que vousne l' ydez pas mais je le pose aux cliniques privées	1
elle pourrait rentrer dans un gouvernement ps	elle pour rait rentrer dans un gouver e men e le ens ens pa	elle pourrait rentrer dans un gouvernement je	0
on on le connaît avec ses forces et faiblesses il était très tendu très irrité	on on le connaît avec ces forces et de blaces il était très tendu très gérité	on on le connaît effectivement s' il était très tendu très érité	1
or le dirigeant de cosmos lui même quand il a été interrogé en novembre deux mille onze	or le dirigeant de cosmos lui-même quand il a été interrogé en novembre deux milles onze	or le dirigeant de kosmos lui-même quand il a été interrogé en novembre deux mille onze	1
cinquante milliards d' euros de hausse de recettes cumulés à une baisse du même montant des dépenses	cinquante milliards d' euros de hausse de recettes cumuler à une baisse du même montant des dépenses	cinquante milliards d' euros de hausses de recettes cumulées à une baisse du même montant des dépenses	0
pas étalé dans le dans la presse	pas italien dans la dans dans la presse euh	pas est allé dans la dans dans la presse euh	0
s' étaient trop facilement accommodés	était trop facilement accommoder	c' était trop facilement accommodé	0
c' est le rôle des médias de dire quand ça va bien et quand ça ne va pas bien aussi	e rôle des médias de dire quand ça va bien ' e de dire quand ça va mal aussi	c' est le rôle des médias de dire quand ça va bien de dire quand ça va aussi	1
comme le sont aujourd'hui les états c' est un	comme le sont aujourd' hui les etats c' est un	comme le sont aujourd' hui les états c' est un	0
sur la tyrannie de l' émotion	c' est la turannie de l' émotion	c' est la puramie de l' émotion	1
on peut dire que cette semaine elle vaut pour un mois de campagne	on peut dire que cette semaine elle vaut pour euh un mois de campagne	peut dire que cette semaine elle vaut pour un mois de campagne	1
après quelques jours de cavale c' est aujourd'hui que les autorités espagnoles les ont extradés vers la france	après quelques jours de cavale euh c' est aujourd' hui que les autorités espagnoles les ont extradées vers la france	après quelques jours de caval euh c' est aujourd' hui que les autorités espagnoles les ont extradés vers la france	1
côté dites le	côté dites-le	côté ditesle	1
et donc le plus suivi médiatiquement	et donc le plus suivi on a di	le plus suivi giaka	1
il fait du vélo dit votre fille	il fait du vélo de votre fillehein	du vélo	1
qu' entre temps le fameux observatoire a changé	qu entre-temps le fameux observateir a changé	qu' entre temps le fameux observatoir a changé	0
ce soir françois hollande a été conforté dans dans sa stature dans sa capacité à diriger l' état	ce soir françois hollande a été conforté dans dans sa stature euh dans sa capacité à diriger les femmes	ce soir françois hollande a été confortée dans dans sa stature en sa capacité à diriger les mains	0
il y a des massacres en syrie une situation dramatique	euh il y a des massacreseh en syrie une situation dramatique	euh il y a des massacres en syrie une situation dramatique	0
on est quand même beaucoup plus tranquille	on est quand même euh beaucoup plus tranquilles	on est quand même euh beaucoup plus tranquille	0
pour aller tout droit dans la direction annoncée ou est ce qu' il va continuer à tirer des bords	pour aller tout droit dans la direction annoncée ou est-ce qu' il va continuer à tirer des bords	aller tout droit dans la direction annoncée ou est ce qu' il va continuer à tirer des bords	1
le donc pas de cravate le le week end prochain	le ne pas de tralat le le week-end prochain	tout de même pas cravate le le week end prochain	0
c' est le rôle des médias de dire quand ça va bien et quand ça ne va pas bien aussi	c' est le rôle des médias de dire quand ça va bien c' de dire quand ça va aussi	c' est le rôle des médias de dire quand ça va bien de dire quand ça va aussi	0
ça vaut pas cinquante centimes non c' est pas ça	n ba vrai quant en dit maion c' est pas ça	pas cinqante brondimaihen c' est pas ça	0
serait elle atteinte faut il bel et bien un électrochoc pour relancer la compétitivité des entreprises françaises	serait-elle atteinte faut-il bel et bien un électro choc pour relancer la compétitivité des entreprises françaises	serait-elle atteinte faut-il bel et bien un électrochoc pour relancer la compétitivité des entreprises françaises	0
écoutez c' est à nous de choisir la bonne	(écoutez c' est à nous de choisir la bonde	écoutez c' est à nous de choisir la bande	0
reste qu' arcelormittal n' est pas encore décidé à céder ce site dans sa globalité	reste le quartier l' hormital n' est pas encore décidé à céder ce site dans sa globalité	reste carcel est or mittal n' est pas encore décidé à céder ce site dans sa globalité	0
le voilà donc récompensé au festival du film policier de beaune	voilà donc récompensé au festival du film policier de beaune	le voilà donc récompensé au festival du film policier de baunes	1
quelles sont nos chances dans la catégorie boxe pour ces jo à londres	quels sont nos chances euh dans la catégorie box euh pour euh c go à londres	quelles sont nos chances dans la catégorie box pour eux ces gyaw à londres	0
pour évacuer son stress le producteur a un truc imparable	pour exacuaison stress le producteur un truc imparable	pour évacuer son stress le producteur un truc infarable	0
des fans qui vont avoir des haut le coeur	des femmes qui vont avoir des hauts le coeur	des fens qui vont avoir des haut de coeurs	0
il fait comme ns ns	domenech	il fait comme une s n	0
de la majorité précédente et qui mettent plus de justice et plus d' équilibre	majorité précédente et qui mettent plus de justice et plus d' équilibre	la majorité précédente et qui mettent plus de justice et plus d' équilibre	0
on l' avait laissé y a onze mois	on avait laissé y a onze mois	on l' avait laissé i y a onze mois	0
commis une percée énorme dans dans l' opinion publique	comme une percée énorme dans l' opinion	comme une percée énorme dans dans l' opinion	0
en deux mille neuf le gouvernement lui s' apprête à annoncer de nouvelles mesures de rigueur	en deux milles neuf le gouvernement lui s' apprête à annoncer deux nouvelles mesures de rigueur	en deux milles neuf le gouvernement lui s' apprête à annoncer de nouvelles mesures de rigueur	0
heureusement qu' on l' a beaucoup réduit	donc deuxoi l' a beaucoup réduit	on a beaucoup réduit	0
c' était on le présente aujourd'hui comme l' un des meilleurs animateurs radio et télé de sa génération malheureusement	c' était on le présente aujourd' hui comme l' un des meilleurs animateurs radio et télé de sa génération malheureusement	c' était on le présente aujourd' hui comme l' un des meilleurs animateurs radios et télé de sa génération malheureusement	0
à condition aussi que ces hommes que l' armée utilise ces armes	condition aussi que euh ces hommes qui l' armée euh euh utilisent ces armes	condisition aussi que euh ces hommes que l' armée euh euh utilise ces armes	1
sur la vie politique	dans la vie politique	c' est la de politique	1
la culture et la compétence de peillon	la culture et la compétence de payon	culture et la compétence de peillon	0
rassemblant des personnalités politiques magistrats policiers journalistes intellectuels et même mes chers collègues et même des parents de victimes	rassemblant des personnalités politiques magistrat policiers journalistes intellectuelles et même mes chers collègues et même des parents de victimes	rassemblant des personnalités politiques magistrat policiers journalistes intellectuels et même mes chers collègues et même des parents de victimes	0
ça n' a rien à voir c' est des histoires de contrat du service public	e n vai rien avoir c' est le des ees de on er a du service public	de a e vor ea a voi e le de e e e e de e a du ser vi e e e ei li	1
je suis tout à fait d' accord avec lui il faut peut être parler davantage de bande	je suis tout à fait d' accord avec lui il faut peut-être parler davantage de bande	suis tout à fait d' accord avec lui il faut peut être parler davantage de bande	1
ce matin nous avons la sortie du live de la tournée d' hubert félix thiéfaine	matin nous avons la sortie du live de la tournée de hubert félix thiéfaine	ce matin nous avons la sortie du live de la tournée d' hubert falixtieiffen	0
nous n' accepterons aucune leçon	n' acceptons aucune leçon	nous n' acceptons aucune le sons	1
très spécialisée de dans la vente d' un matériel hyper sophistiqué	euh très spécialisé euh dans la vente d' un matériel hyper sophistiqué	très spécialisés dans la vente de matériels hyper sophistiqué	1
parlons parlons à présent parlons à présent	parnons parlons à présent parlons à présent	après on parlera présent	1
pour pour lui pour nous et un moment très très agréable	poureuh pour lui pour nous et un moment très très agréable	pour euh pour lui pour nous et un moment très très agréable	0.5
à des moments où il devrait le faire je pense notamment à la libération de florence cassez par exemple	à des moments où ils devrait le faire je pense notamment euh à la libération de florence cassé par exemple	à des moments où il devraint le faire je pense notamment euh à la libération de florence cassé par exemple	1
oui alors c' est c' est un peu l' avenir	oui alors euh euh c'est c' est un peu l' avenir	oui alors euh euh c' est c' est un peu l' avenir	1
elle me rappelle par certains à certains égards celle de ma campagne de deux mille sept	elle ne rappelle par certains à certains égards celle de de a campagne de deux mille sept	elle me rappelle par certains euh à certains égards celle de de la campagne de deux milles sept	0
la zone euro va s' effondrer et on va ressembler à la grèce ou à l' espagne	la zone euro va s' effondrée e on va ressembler à a grésseou à l' espagne	un zone euro va s' effondrer on va sembler agresser l' espagne	1
c' était le mouvement de résistance défense de la france	euh c' était le mouvement de résistance défense de de la france	c' était le mouvement de résistance des forces de la france	1
en direct avec candice mahout qui prend elle aussi l' avion tout à l' heure	avec candice mahout qui prend un missile avant tout à l' heure	en direct aveclandis mao qui prend même aussi l aion tout à l' heure	0
le le début de centres nucléaires militaires	le début du centre nucléaire militaire	le le le début de centres nuclé militaires	1
la droite populaire après la droite humaniste voici la droite forte deux jeunes pousses de l' ump	la droite populaire après la droite humaniste voici la droite forte de jeunes pouses de l' ump	droite populaire après la droite humaniste voici la droite forte deux jeunes pousses de l' ump	0
et quand on vous dit que les fans sont prêtes à tout c' est vraiment prêtes à tout	et quand on vous dit que les fans sont prêtes à tout c' est vraiment prête à tout	quand on vous dit que les femmes sont prêtes à tout c' est vraiment tout	1
ont fait la démonstration que ils avaient	ont fait la démonstration que euh ils avaient euh	fait la démonstration que ils avaient	1
on l' avait laissé y a onze mois	on l' avait laissé i y a onze mois	on avait laissé y a onze mois	1
hollande a eu du mal à démarrer si je puis dire et après on n' a pas pu l' arrêter	euh hollande a eu du mal à démarrer si je puis dire et après) on n' a pas pu l' arrêter	euh au lendemain du mal à démarrer si je puis dire et après on n' a pas pu l' arrêter	1
la forme de défiscalisation sur les heures supplémentaires dans le dans le privé	la forme de défisculisation sur les heures supplémentaires dans le dans le privé	l la faè de défiscalisation sur les heures supplémentaires dans le dans le privé	1
ce matin nous avons la sortie du live de la tournée d' hubert félix thiéfaine	ce matin nous avons la sortie du live de la tournée d' hubert falixtieiffen	matin nous avons la sortie du live de la tournée de hubert félix thiéfaine	1
d' accord avec ça danielle schweisguth	d' accord avec ça euh daniel chosgoude	d' accord avec ça euh danièle chose boute	1
d' accord avec ça danielle schweisguth	d' accord avec ça euh danièle chose boute	d' accord avec ça euh daniel chosgoude	0
mais est ce que ces entreprises françaises comme cosmos savaient comment le régime utilisait leur martel leur matériel	ma is est-ce que ces entreprises françaises comme cosmose savaint euh comment le régime utilisait leur marteill() leur matériel	ai mais est-ce que ces entreprises françaises comme euh causmose savaient euh comment le régime utilisait leur marté leur matériel	0
autre atout qui ne vous mettra pas mal à l' aise dans cette saga une française	tout qui ne vous mettra pas mal à l' aise dans cette saga française	atout qui ne vous mettra pas mal à l' aise dans cette saga français	0
infléchi ou est ce qu' il a	unen fléchi ou est-ce qu' il a	ici ou est ce qu' il a	1
places à vendre	ça vendre	la savendre	1
c' est à lui même	c' est euh à lui-même	êtes à lui même	1
remède ici j' en ai entendu tout à l' heure quelques propositions	remède ici j' en ai entendu tout à l' heure quelques pro) propositions	rome a d' ici j' en ai entendu tout à l' heure quelques pro pre positions	1
et on voit aujourd'hui où se trouve la grèce alors justement est ce que c' est un business rentable	on voit aujourd' hui on se trouve la grèce euh justement si le c' est un businesse fontable	et on voiteu aujourd' hui ou se trouve la graisse alor justement est-ce que c' est un business rentable	0
bonsoir catherine frot	bonsoir catherine fraud	bonsoir catherine fro	0
ils se disputeront des médailles dans trois cent deux épreuves devant un parterre impressionnant de spectateurs	ils se disputeront des médailles dont trois cents deux épreuves devant à part ter impressionnant de spectateurs	ils se disputeront des médailles dans trois cents deux épreuves devra partaire impressionnant de spectateurs	0
c' est le rôle des médias de dire quand ça va bien et quand ça ne va pas bien aussi	c' est le rôle des médias de dire quand ça va bien de dire quand ça va aussi	e rôle des médias de dire quand ça va bien ' e de dire quand ça va mal aussi	0
trente milliards on est passé entre deux mille sept on était à	milliards on est passé entre deux mille sept on mettait	trente milliards on est passé entre deux milles sept on atétaa(t)	0
vient du ministre des affaires européennes lui même	()) du ministre des affaires européennes lui-même	(béin du ministre des affaires européen lue	1
coûtent les dépenses de santé chaque année il y aura des objectifs de dépenses qui seront fixés chaque année	les dépenses de santé chaque année il y aura des objectifs de dépenses qui seront fixés chaque année	coûte les dépenses de santé chaque année il y aura des objectifs de dépenses euh qui seront fixés chaque année	0
a été amené à fournir dans le cadre d' un contrat ce type de matériel	a été amené à fournir euh dans le cadre d' un contrat ce type de matériels	a été amené à fournir euh dans le cadre d' un contrat ce type de matériel	0
je peux vous dire que y a pas de stress en tout cas y en a beaucoup moins	je peux vous dire qu' il y a pas de stresse en tout cas il y en a beaucoup moins	je peux vous dire qu' il y a pasde stresse en tout cas l y en a beaucoup moins	1
donc tout d' un coup il descendait de l' olympe si vous voulez voilà donc il descendait de l' olympe	donc euh tout d' un coup i(l) decendait de l' olympe est au tour e e e o o il e voila donc il decendait de l' olymp	donc euh tout d' un coup il descendait de l' ola s' est autour de e on po e qo e la donc il descendait de l' oli	1
à peine le débat commencé donc que déjà la première salve	a peine le débat commencé donc que déjà la première salve	à peine le débat a commencé donc que déjà la première salve	1
oui il est jeune il est il	oui il est jeune et il	oui il est jeune il estil	0
avec cinquante six pour cent des voix céline bracq bonjour vous êtes directrice adjointe de bva françois hollande progresse	avec cinquante six pour cent des voix céline bragg bonjour vous êtes directrice adjointe de bva françois hollande progresse	avec cinquante six pourcent des voix céline brague bonjour vous êtes directrice adjointe de bva françois hollande progresse	1
un grand rassemblement de l' unité nationale	un grand rassemblement de l' unité bon nationaleet cetuni	un grand rassemblement de l' unité bon national et c' est un	0
alors pourquoi valéry giscard d' estaing vote nicolas sarkozy	alors pourquoi valéri giscard d' estaing vote nicolas sarkozy	alors pourquoi valéry giscard d' estaing votre nicolas sarkozy	1
ça s' améliore	ça ser améliore	c' est-à-dire	1
on était au dixième rang	vou était eu dixième rang	vous êtes en dixième ra	1
et aussi parce dit elle elle était jolie françois hollande possède un nom un niveau correct tout comme françois bayrou	et aussi parce que dit-elle elle était jolie françois hollande possède un un an un niveau correct ou comme françois bayrou	et aussi parce que dit-elle elle était jolie françois hollande possède un un an un niveau correct tout comme françois bayrou	0
crier aussi leur espérance	créer aussi leur espérance	criez aussi leur espérance	0
et vous savez pourquoi parce que ces fameux entrepreneurs de start up	et vous savez pourquoi parce que ces fameux entrepreneurs de starup	et vous savez pourquoi parce que ces fameux entrepreneurs de startop	0
pas étalé dans le dans la presse	est allé dans le dans dans la presse	pas est allé dans la dans dans la presse euh	0
en revenant à trois pour cent du déficit et c' est c' est douloureux avec un effort partagé et ciblé	en revenant à trois pourcent de déficit et c' est c' est touloureux avec un effort partagé et ciblé	en revenant à trois pour cent de défficit et c' est c' est touloureux avec un effort partagé et ciblé	1
repartons à londres retrouver notre consultant en boxe c' est un médaillé d' or messieurs brahim asloum bonsoir brahim	repartons à londres retrouver euh notre consultant boxe c' est un médaillé d' or messieurs brahime asloum bonsoir brahim	repartons à londres retrouver notre consultant box c' est un médaillé d' or messieurs brahim asloum bonsoir brahim	0
jean marc ayrault est en pole position pour matignon	jean-marc ayrault est en pôle position pour euh matignon	jean-marc ayrault est en paul position pour matignon	1
parlons parlons à présent parlons à présent	après on parlera présent	parnons parlons à présent parlons à présent	0
qu' elle a pas voulu sombrer dans la démagogie ni dans les promesses faciles ni dans les arguments	elle a pas voulu sombrer dans la démagogie ni dans les promesses faciles ni dans les arguments	qu' elle a pas voulu sombrer dans la démagogie ni dans les promesses faciles euh ni dans les arguments euh	1
et oui objectif protester contre mille quatre cents suppressions de postes annoncées alors que	eh oui objectif protester contre mille quatre cents suppressions de postes annoncées alors que	h oui objectif protester contre mille quatre cents suppressions de postes annoncées alors que	1
ça a rattrapé ça a retrouvé les dizaines de fois où il a toujours été comme ça	euh ça a rattrapé ça a retrouvé les dizaines de faux il a toujours été comme ça	euh ça a atttrapé ça a retrouvé les dizaines de fois elle a toujours été comme ça	0
qui est un aciériste un industriel qui n' est pas un financier	qui est un assiériste un industriel qui n' est pas un financier	c' est un aciéristes un industriel qui n' est pas un financier	0
s' il est question de l' autorité de la france la question de sa de sa de sa potentialité	si la question de l' autorité de la france la question de de ça ça peut se potentialités	si la question de l' autorité de la france la question de sa toutes ses potentialités	0
pour se libérer des idées reçues qu' elle avait sans doute auparavant sur l' homosexualité	pour euh se libérer des idées reçues qu' elle avait sans doute auparavant sur le mossé extraordinaire	pour euh se libérer des idées reçues qu' elle avait sans doute auparavant sur l' homosexualiste	0
mais franchement vous	on est franchement	maintenant je moi	1
nos nos nos notre figure de proue notre candidat jean luc mélenchon	ce nos nos notres figures de coups euh notre candidat euh jean-luc mélenchon	ce nos no( notre figure de couph notre candidat euh jean-luc mélenchon	0
nous avons buzz aldrin qui était hier à paris	nous avons peu à aldrine qui était hier à paris	nous avons peux aldrich qui était hier à paris	1
culture et vous on va parler des oscars avec glenn close habillée en monsieur	culture et vou on va parler des oscars avec glale clause habillan monsieur	culture et vous on va parler des oscars avec glaine clause a billan monsieur	0
est ce que nous en france	est-ce que nous en france	ce que nous en france	1
monsieur le président mesdames messieurs les députés monsieur le ministre luc chatel	le président mesdames messieurs les députés monsieur le ministre luc chatel	monsieur le président mesdame messieurs la député monsieur le ministre luc chatel	0
il a eu deux périodes celle d' avant l' arrêt	euh il a eu euh deux périodes celle d' avant l' arrêt	euh il y a eu euh deux périodes celle d' avant l' arrêt	1
et les statuts doivent	et les statues de	il t les statuts de	1
et plus surprenant lady gaga	est plus surprenant e lai di daga	et le plus surprenant lestis gaga	0
quels dégats pourraient provoquer ces armes chimiques	quel dégâts pourrait provoquer ces armes chimiques	quel dégât pourrait provoquer ses armes chimiques	1
sais pas quel	sait pas quelle	sait pas que quel	1
qu' entre temps le fameux observatoire a changé	qu' entre temps le fameux observatoir a changé	qu entre-temps le fameux observateir a changé	1
je ferai je ferai cent pour cent de ce que nous déciderons collectivement de faire	je ferais je ferais euh cent pour cent euh ce que nous déciderons collectivement de faire	je ferais je ferais euh cent pourcent de ce que nous déciderons collectivement de faire	0
dix huit heures trente après	dix-huit heures trente après	dix-huit heures trene après	1
du dernier adieu à whitney houston	dernier adieu à whitney houston	l du dernier adio à witry juston	1
ce soit rendu possible avec	se resoit rendu possible avec euh	se() soit rendue possible avec euh	0
et laurent neumann pour marianne bonjour laurent	et laurent deman pour marianne bonjour laurent	laurent neumann pour marianne bonjour laurent	0
les années quatre vingt	années quatre	les années quatre-vingt	0
cinquante milliards d' euros de hausse de recettes cumulés à une baisse du même montant des dépenses	cinquante milliards d' euros de hausse de recettes cumulée à une baisse du même montant des dépenses	cinquante milliards d' euros de hausse de recettes cumulées à une baisse du même montant des dépenses	0
cette demande a été formulée	cette euh demande a été formulée	cetteuh demande a été formulée	1
ses failles et et parfois justement ce que ça pouvait avoir de	euh s' éfaillent et euh et parfois justement ce que ça pouvait avoir de enmer gural	euh ces faille et euh et parfois ou justement ce que ça pouvait avoir de euh l' oupéroa	0
et on voit aujourd'hui où se trouve la grèce alors justement est ce que c' est un business rentable	et on voit ou jour le ou se trouve la grassee justement si le c' est un bisines se ren table	on voit aujourd' hui on se trouve la grèce euh justement si le c' est un businesse fontable	0
ces vingt septième jeux olympiques la france ce soir sera représentée par le premier ministre jean marc ayrault	ces vingt septième jeux olympiques la france soir sera représentée par le premier ministre jean marc ayrault	ces vingt-septièmes jeux olympiques la france ce soir sera représentée par le premier ministre jean-marc ayrault	0
un premier plan de départ est déjà à l' oeuvre alors le volontariat ils n' y croient plus	un premier plan de départ est déjà à l' oeuvre alors le volontariat il n' y croit plus	premier plan de départs est déjà à l' oeuvre alors le volontariat il n' y croient plus	1
ont représenté environ vingt pour cent des règlements de comptes commis sur le territoire français métropolitain	ont représenté environ vingt pourcent des règlements de comptes commis sur le territoire français métropolicain	représenter environ vingt pour cent des règlements de comptes commis sur le territoire français métropolitain	1
mais pour être sur la ligne de départ une condition obligatoire sept mille neuf cent vingt quatre parrainages	mais pour être sur la ligne de départ condition obligatoire sept mille neuf cents vingt quatre parrainages	mais pour être sur la ligne de départ une condition obligatoire sept milles neuf cents vingt quatre parrainage	0
je pense que les gens qui sont là avant tout c' est des fans de tolkien	je pense que des gens qui sont là avant tout c' est des fammes de tocken	je pense que les gens qui sont là avant tout c' est des snes de tocken	1
johnny en mode bisous applaudi par la foule johnny en mode ray charles public attentif	johnny en mode bisou applauddi par la foule johnny en modchles public attentif	johnny en motde bisou applaudi par la foul jonyl en mode ra e charles public attentif	0
c' est différent alors pour répondre directement à bruno le maire que j' écoute toujours avec attention parce que	différents alors pour répondre directement bruno le maire j' écoute toujours avec attention parce que	est différent alors pour répondre directement oui bruno le mare moi j' écoute toujours avec attention parce que	1
en quelque sorte assigné à résidence à l' hôtel de la gazelle d' or à taroudant	en quelque sorte a signé à résidence à l' hôtel de la gazelle d' or à tarroudan	quelque sorte assigné à résidence à l' hôtel de la gazelle d' or à taroudant	0
il est pas très tendre avec avec eva joly	à très tendre euh avec avec evagn	tendre euh avec avec évag non	1
ce ce cette manière de le gommer est en fait absolument énorme	euh absolument énorme	euhh ce ce cette manière de le gommer est en fait euh absolument énorme	0
le président ne sera pas là avant dix minutes	le président na sera pas là vant timiné	le président ne sera pas là ban diminuer	1
il y a la taxe oui bon	lié à la tase oui mai	li à la tasse oui mas	0
ils me l' ont dit	le melon	t ills me l' ont dit	0
donc vous voyez que la politique fiscale du gouvernement que les écologistes tousenon soutenons totalement	donc vous voyez que la politique fiscale du gouvernement que les écologistes nou se nons soutenons totalement	donc vous voyez que la politique fiscale du gouvernement que les écologistes tout ce noubre soutenonc totalement	1
le syndicat national des pilotes doit voter l' adoption de cet accord d' ici la mi août	le syndicat national des pilotes doit voter l' adoption de cet accord d' ici la mi- août	le syndicat national des pilotes doit voter l' adoption de cet accord d' ici la mi-août	0
à mille huit cent cinquante euros brut	à mille huit cents cinquante euros euh brut	mille huit cents cinquante euros brut	1
a su résister à l' agressivité qui était celle régulièrement de nicolas sarkozy	euh a su euh résister à l' agressivité qui était celle régulièrement de nicolas sarkozy	euh a su euh résister à l' agressivité qui était celle régulièrement euh de nicolas sarkozy	1
pour la russie comme pour la france	pour la russi comme pour l aurop	ici	1
tel était le mot d' ordre pour les six mousquetaires de l' ump hier soir à provins	tel était le mot d' ordre pour les six mousceteires de l' ump hier soir à provin	tel a été le mot d' ordre pour les six mousquetaires de l' ump hier soir à provin	0
ont fait la démonstration que ils avaient	on fait la démonstration que ils avaient euh	ont fait la démonstration que euh ils avaient euh	0
merci andré paccou dominique rizet manuel valls dit le sport l' immobilier	merci à andré pacou dominique rizet manuel valls dit le sport l' immobilier	andré pachoux dominique frisait manuel valls dit le sport l' immobilier	1
culture et vous on va parler des oscars avec glenn close habillée en monsieur	culture et vous on va parler des oscars avec glaine clause a billan monsieur	culture et vou on va parler des oscars avec glale clause habillan monsieur	1
on a eu alain bernard on a camille lacourt yannick agnel et d' autres et en même temps	euh on a eu alain bernard euh on a euh camille la cour et une camion des d' autres et en même temps	euh on a eu alain bernard euh on a euh camis la cour y an ny canyadet d' autres et en même temps	1
c' est difficile quand on augmente davantage les dépenses	c' est difficile dont on augmente d avantage les dépenses	est difficile dont on augmente davantage dépense	1
on l' avait vu s' essayer au théâtre et au cinéma	l' avait vu s' essayer au théâtre et au cinéma	on l avait vu s' essayer au théâtre et au cinéma	0
on faisait la grande famille c' était de midi et demi de douze heures trente à treize heures trente	euh on faisait la grande famille c' était de midi et demi de douze heures trente à treize heures trente	on faisait la grande famille est et de midi et demi de douze heures trente à treize heures trente	1
à nos résultats	un non résultat	nos résultats	0
pas de dépénalisation	dépénalisation	pas e dépénalisation	0
si l' on regarde dit il les engagements mirobolants de quatre vingt un quatre vingt quinze	si l' on regarde dit-il les engagements miro bolland de quatre-vingt n quatre-vingt quinze	si l' on regarde dit-il les engagements mir au bolan de quatre-vingt un quatre-vingt quinze	0
nous on parle aux français on parle aux électeurs on parle au coeur du peuple militant et justement	nous on parle aux français on parle o u on parle aux électeurs on parle au coeur du peuple militant et justement	nous on parle aux français on parle vous lon e on parle aux électeurs on parle au coeur du peuple militant et justement	1
aidez moi à faire du vingt deux avril une surprise	aidezm moi à faire du vingt deux avril une surprise	et des mois àfin du vingt deux avril une surprise	1
maxime poullaouec est il avec nous pour les infos trafic	maxime poulawec est-il avec nous pour les infos trafics	maxime pour la ouedec est il avec nous pour les infos trafic	1
que vous ne l' ayez pas mais je le pose aux cliniques privées	que vousne l' ydez pas mais je le pose aux cliniques privées	que vous ne l' yiez pas mais je le pose aux cliniques privé	0
je déteste les complications les préparations tarabiscotées les décorations inutiles	je déteste les complications les préparations tarbiscotées les décorations inutiles	des tests les complications les préparations tara biscottes et les décorations inutiles	1
non je risque de toucher bond	non je reste de tout se ponse	non c' vraiais que peut pas tout fait	1
il me manque une direction	qu' une direction	maintenant qu' une direction	1
et donc il s' agit d' apprécier	et donc euh il s' agit euh d' apprécier	donc il s' agit d' apprécier	1
je préviens le bourget pour leur dire qu' on risque de décoller en retard	je ai conbien le bourger pour leur dire qu' on risque de décolér en tea	je conais le bonger pour leur dire qu' on risque d être découlér ente	1
qu' est ce	qu' e	qu' est-ce	0
au delà de ça bien sûr j' aurais aimé qu' il soutienne l' écologie politique au delà	au-delà de ça bien sûr j' aurais aimé euh qui soutienne l' écologie politique au-delà	au-delà de ça bien sûr j' aurais aimé euh qu' il soutiennen l' écologie politique au-delà	0
eddy merckx de de tout temps on a eu des dominateurs dans le peloton des des grands champions	et dimerx euh en de de tous temps on a eu des dominateurs dans le peloton des des grands champions	et dhi merx euh en de de tout temps on a eu des dominateurs dans le peloton des des grands champions	0
est ce qu' on en est capable	ce qu' on en est capable	est-ce qu' on en est capable	0
avec beaucoup de réactivité hier après midi avec notre collègue pouria amirshahi	avec beaucoup de réactivité hier après-midi avec notre collègue pourria mir chali	avec beaucoup de réactivité hier après-midi avec notre collègue pourria mir chayi	0
non seulement elle a pas diminué le millefeuille mais elle l' a augmenté en créant les métropoles	non seulement elle a pas diminué le mélecei mais elle l' a augmenté en créant les métropoles	non seulement elle a pas diminué le méle chai mais elle l' a augmenté en créant les métropoles	1
cette demande a été formulée	cetteuh demande a été formulée	cette euh demande a été formulée	0
a t on appris sur les candidats notamment sur leur tempérament	a-t-on appris sur euh les candidats notamment sur leurs tempéraments	t on appris sur les candidats notamment sur leur tempérament	1
ça va être le début on est dans les starting blocs et on espère que ça va bientôt partir	ça va être le début on est dans les starting bloks et on espère que ça va bientôt partir	cela va être le début on est dans les starting block et on espère que ça va bientôt partir	1
merci beaucoup d' être sur le plateau de bfm tv bonsoir danièle delpeuch	merci beaucoup d' être sur le plateau de bfm tv bonsoir daniele delpeu	merci beaucoup d' être sur le plateau de bfm tv bonsoir daniel del peut	1
c' est vrai que y a beaucoup d' attente donc on déconseille aux sportifs qui	euh c' est vrai qu' y a beaucoup d' attentes donc ont des conseils au sportifs qui	euh c' est vrai qu' il y a beaucoup d' attentees donc ont des conseils au sportifs qui	1
on là on va mettre une demie heure un professeur et trente enfants	on l'a on va mettre une demi-heure on va un professeur et trente enfants	on là on va mettre une demi-heure on v( un professeur et trente enfants	1
mais c' est vos	mais s'is vous	c' est beau	1
le le la table avec ses médicaments qui jouxtait sa qui jouxtait son lit je le revois encore regardant	une table avec ces médicaments qui jouxte sa qui toute cette folie je me revois encore regardant	le le l' attaque d' un effet uniquement qui s' occupaient ça euh qui oublie s' enlis euh i(ls) je le revends encore au gardant euh	1
oui pourquoi pas ça peut donner des vocations	oui pourquoi pas ç' est peu donune évocation	oui pourquoi pas ça ponnait une évocation	0
évidemment on cible sur ceux qui peuvent être considérés éventuellement comme des opposants et c' est ainsi que	euhon évidemment en cible sur ceux qui peuvent être considérés éventuellement comme des opposants et c' est ainsi que	on est évidemment en cible sur ceux qui peuvent être considérés éventuellement comme des opposants et c' est ainsi que	0
c' est la mouise pour beaucoup	c' est la bouillese pour beaucoup de peuqeu	c' est la mouilleuse pour beaucoup	0
ils ont réussi à monter en gamme regardez les vins du languedoc roussillon	il)s ont réussi à monter en garme regardez les vings du doncgudoce roussillon	ils ont réussi à monter en garme regardez les vin du donge doc roussillon	0
n' ont plus le même âge	nont plus le même a	non ont plus le même âge	0
tout même si y en avait sur les	tout mai mai si l y a e sur les	tout mois mas sine a e sor es entai	1
florence alors à la une des hebdos anne lauvergeon sans état d' âme	bougies alors à la une des hebdos anne lauvergeon sans état d' âme	flarane le rougi alors à la une des hebdo anne levergeonc sans état d' ame	1
c' est ce qu' on appelle une anaphore en rhétorique la répétition de la même formule en début de phrase	ce qu' on appelle une informe en rhétorique la répétition de la même formule en début de phrase	je vous appelle une effort en rhitorique la répétition de la même formule en début de phrase	1
il me manque une direction	il m' manque une direction	qu' une direction	1
henri emmanuelli dire que on va devoir travailler plus tard	henri emmanuelli euh dire que on va travailler plus tard au débat c' est-à-dire que	henri emmanuelli euh dire que on va devoirler plus tard au dé( c' est	1
trop généreuse pour certains ça c' est une conviction personnelle je sais qu' elle fait l' objet de débats	trop généreuse pour certains ça c' est une conviction personnelle je sais qu' elle fait l'objet de débat	trop généreuse pour certains ça c' est une conviction personnelle je sais qu' elle fait l' objet de débat	1
et manifestement en l' état nous ne sommes pas audible	et manifestement en l' état nous ne sommes pas au dit	et manifestement en l' état nous ne sommes pas au dibe)	0
dix huit heures trente après	dix-huit heures trene après	dix-huit heures trente après	0
mais est ce que vous savez combien coûte par exemple la baisse de la tva sur la restauration	mais est-ce que vous savez combien le coûte par exemple la baisse de la tva sur la restauration	mais est-ce que vous savez combien de coûte par exemple la baisse de la tva sur la restauration	1
non je risque de toucher bond	non c' vraiais que peut pas tout fait	non je reste de tout se ponse	0
de poursuivre les réformes structurelles de l' hôpital or ces réformes structurelles de l' hôpital qui sont le seul moyen	poursuivre les réformes structurelles de l' hôpital or c' est réforme structurelle de l' hôpital qui sont les seuls moyens	poursuivre les réformes structurelles de l' hôpital orsay réforme structurelle de l' hôpital qui sont les seuls moyens	1
et il était vraiment je pense et c' est peut être aussi pour ça finalement que que	et il était vraiment je pense euh et c' est peut-être aussi pour ça finalement que que	et il était vraiment je pense euh t c' est peut-être aussi pour ça finalement que que	1
madame vers nous	madame ernaude	madame bernau	0
et c' est là	euh cela	et c' est la	0
c' est la compétition en fait	laiction en fait	abutition en fait	1
mario draghi considère que cette irréversibilité	draghi considère que cette irréversibilité	et o dragui considèren que cette irréversibilité	1
l' info trafic avec green accres point com moteur de recherches immobilières sur internet	l' info trafic avec grinac point com moteur de recherche immobilière sur internet	l' info trafiqu avec grinag point com moteur de recherche immobilière sur internet	1
comment il s' appelle	et ça pe e	il s' appelle	0
le le début de centres nucléaires militaires	le le le début deux centres nucléaires militaires	le le le début de centres nuclé militaires	1
honoré au festival lumière le réalisateur qu' on sait engagé en a profité pour se révolter	aurait au festival lumière le réalisateur conseil engagée en a profité pour se révolter	au nord-et au festival lumière le réalisateur conseil engagé et on a profité pour se révolter	1
on a tous besoin d' un hobby	on a tous besoin d' aobéir	on a tous besoin d' à obéi	0
trente milliards on est passé entre deux mille sept on était à	trente milliards on est passé entre deux milles sept on atétaa(t)	milliards on est passé entre deux mille sept on mettait	1
arrivée de la dégradation orageuse de l' aquitaine à la région lilloise encore du soleil en allant	arrivé de la dégradation orageuse de l' aquitaine à la région lilloise encore du soleil en allant	arrivée de la dégradation rageuse de l' aquitaine à la région lilloise encore du soleil en allant	1
c' est pas si simple à utiliser	je ne sais pas si simple utiliser	mais c' est pas si simple à utiliser	0
alain bernard camille lacourt yannick agnel	alain bernard cami lacour ya ni kanel	alain bernard ca a mis lacourt yanni caniel	1
c' était l' info trafic avec green accres point com moteur de recherches immobilières sur internet	c' était l' info trafiqu avec grinag point com moteur de recherche immobilière sur internet	c' était l' info trafic avec grinac point com moteur de recherches immobilières sur internet	0
à condition aussi que ces hommes que l' armée utilise ces armes	aussi que ces hommes que l' armée utilisent ces armes	condition aussi que euh ces hommes que l' armée euh euh utilise ces armes	0
sur la vie politique	c' est la de politique	dans la vie politique	0
de la résistance est décédé hier soir	de la résistance est décédée hier soir	la résistance est décédée hier soir	1
au petit jeu du my tailor is rich	au petit jeu du miiggtell ezriach	petit jeu du manque de talent ils jouaient chez	1
parce que tout va aller très vite	parce que tout va arriler très vite	est ce que tout va aller très vite	1
mais j' espère que vous ne croyez pas que nous faisons ça cela de gaieté de coeur	et euh t j' espère que vous ne croyez pas que nous faisons ça cela de gaieté de coeur	j' espère que vous ne croyez pas que nous faisons ça cela de gaieté de coeur	0
ça elle l' a dit	l' a dit euh	çaelle l' a dit euh	0
pas étalé dans le dans la presse	pas étaillé dans la dans dans la presse euh	étalée dans le temps dans la presse	1
le président de la république est nouvellement élu il dit je vais réduire la dépense de dix milliards rappelez vous	président de la république est nouvellement élu il dit je vais réduire la dépense dix milles rappelez-vous	président la république et nouvellement élue je vais réduire la dépense dix milliards rappelez vous	0
à gauche on retient son souffle pour mieux laisser éclater sa joie reportage d' aurélien romano	à gauche on retient son souffle pour mieux laisser éclater sa joie reportage d' relien romano	gauche on retient son souffle pour mieux laisser éclater sa joie reportage de aurélien romano	1
si c' est	si	civi	1
en portant effectivement un renouveau de nos idées un renouveau de nos pratiques un renouveau	en portant effectivement à renouveau de nos idées à renouveau de nos pratiques à renouveau	portant effectivement un renouveau de nos idées renouveau de nos pratiques un renouveau	0
mais ce coup de sécateur était imbécile	coûte sécateur été	mais ce coûp de sécateur était un	0
c' est le sourire aux lèvres qu' anders behring breivik a écouté le verdict	c' est le sourire au lèvre kanders bering drevik a écouté le verdict	c' est le sourire au lèvres kander berin drevik a écouté le verdict	1
il m' a fallu un peu de temps pour le découvrir	il m' a fallu un peu de temps pour le découvrer	peu de temps pour découvrir	1
on a continué on a continué à se parler moi ce qui m' a vraiment frappé chez lui	on l' a continué euh on a continué à je parle moi je qui m' a vraiment je frappelé chez lui	on la continua euh on a continué à je parler moi je qui m' a vraiment frappé chez lui	0
je sais pas s' il était avec nous florian gazan animateur radio sur fun radio qui était vraiment	je sais pas s' il est avec nous florent gazan animateur radio sur fun radio qui était vraiment	je sais pas s' il éait avec nous florient gazan animateur radio sur fun ne radio qui était vraiment	1
pour nous soumettre au débat public mais on nous l' a refusé	pour nous soumettre au débat public mais on nous la refuser	pour euh nous soumettre au débat public mais on nous l' a refusé	0
pas de dépénalisation	pas e dépénalisation	dépénalisation	1
est ce bien le moment	c' est bien le moment	est-ce bien le moment	0
je pense que ça n' est pas très opportun à dix jours de la fin d' une campagne présidentielle	euh je pense que ça n' est pas très opportun euh à dix jours de la fin euh d' une campagne présidentielle	je pense que ça n' est pas très opportant euh à dix jours de la fin euh d' une campagne présidentielle	1
il faut être respectueux de notre histoire et en même temps capable de se projeter dans l' avenir	il faut être respectueux de notre histoire et en même temps carnable de se procher dans l' avenir	i(l faut être respectueux de notre histoire et en même temps capable de se projeter dans l' avenir	0
un ciné rapido	un ciné rapidea	un siné rapido	1
encore faut il qu' elle en est à la fois et la volonté et la capacité en tant que telle	encore faut il quelle année à la fois est la volonté et la capacité en tant que telle	encore faut il quelle année à la fois et la volonté et la capacité en tant que telle	0
la mort de jean jé colonna qui était le parrain de la corse du sud il y a	la mort de jean-jicques colonna qui était le parrain de la corse du sud il y a	euh la mort de janger colonna qui était le parrain de la corse du sud y a	1
à condition aussi que ces hommes que l' armée utilise ces armes	condisition aussi que euh ces hommes que l' armée euh euh utilise ces armes	condition aussi que euh ces hommes qui l' armée euh euh utilisent ces armes	0
ça va alors ça y est vous êtes prête	vous êtes faible	ui va lorvsalez vous êtes prêt	0
de la mission de peillon à l' éducation nationale	de la mission de payon à l' éducation nationale	la mission de peillon à l' education nationale	0
renaud laure manaudou ne sait pas fait tatouer sur le corps un papillon un lézard ou un marsupilami	euh renaud laure manaudou ne s' est pas fait tatouer sur le corps un papillon un lésar ou un mar suupil ami	euh renauld laure manaudou ne s' est pas fait d tatouer sur le corps un papillon un lésard ou un marchupilami	1
la compagnie veut proposer des incitations financières à ses pilotes pour les faire travailler au sein de sa filiale transavia	la compagnie veut euh proposer les incitations financières à ses pilotes pour les faire travailler au sein de sa filiale transabia	la compagnie veut euh proposer des incitations financières à ces pilotes pour les faire travailler au sein de sa filiale transavia	0
êtes vous sûr que ce gagnant va rester en france avec les impôts	êtes-vous sûr que ce gagnant va rester en france avec euh les impôts	etes vous sûr que ce gagnant va rester en france avec les impôts	0
qui est un aciériste un industriel qui n' est pas un financier	qui est un assiériste un industriel qui n' est pas un financier	est un aciéristes un industriel qui n' est pas un financier	0
crier aussi leur espérance	cer aussi leur espérance	aussi leur espérance	0
c' était l' événement hier soir à paris ils attendaient tous depuis	c' était l' évènement hier soir à paris ils attendaient tous depuis	était l' événement hier soir à paris ils attendaient tous depuis	1
alors j' ai entendu un peu la démagogie sur les collectivités vous savez sur les	alors j' ai entendu un peu la démagogie sur les collectivités u vovez sur les euh	alors j' ai entendu un peu la démagogie sur les collectivités vous savez sur les euh	0
ce coup de sécateur était totalement imbécile	ce coup de se cateurs était totalement imbécile	ce coup de ces quor était totalement imbécile	1
il y a le risque des interactions	l y a le risque des interactions	y a le risque des interactions	0
alors justement nous nous voilà entrés dans la la période ultra dense de la campagne	alors justement donc nous allons entrer dans la la période euh ultradancee de la campagne	alors justement donc nous vallens entrer dans la la période euh ultradance de la campagne	1
en soixante huit c' était même pas inventé on connaissait pas ces vélos là	euh en soixante huit c' était même pas inventé on connaissait pas ces véloos-là	en soixante huit sept m même pas inventé on connaissait pas ces vélos larmes	1
emile et images peter et sloane début de soirée	emile à image peter esto début de soirée	image pittoresque en début de soirée	1
c' est vrai que selon vous c' est excessif cent soixante neuf millions d' euros pour un seul homme	c' est vrai que selon vous c' est excessifeuh cent soixante neuf millions d' euros pour un seul homme	est vrai que selon vous c' est excessif cent soixante neuf millions d' euros pour un seul homme	1
c' est extraordinaire de vivre ça	c' est extraordinaire de vivre ça et c' est des extraordin b	c' est extraordinaire de vivre ça esttra	0
mais franchement vous	maintenant je moi	on est franchement	0
claude vous voulez me parler de	claude vous les me parlez de de	claude vous voulez parlez de de	0
bruno le maire côté face l' ancien secrétaire d' état en charge des pme	bruno le marre côté face l' ancien secrétaire d' état en charge des pme	bruno le maire côté face l' ancien secrétaire d' etat en charge des pme	0
de sa grand mère ça c' est vraiment c' est c' était ses mots	de sa grand-mère ça c' est vraiment c' est c était ces mots	de sa grand-mère ça c' est vraiment c'est c' était ces mots	0
ça y est les stones ont posé leurs amplis aux etats unis	ça y est l' histon s' oppose et l' ensemble aux états-unis	sayer les stones sont posées leursemble aux états-unis	0
où situeriez vous le discours prononcé ce mardi par jean marc ayrault	où se situe voyez vous le discours prononcé ce mardi par jean marc ayrault	euh où situeriez-vous le discours prononcé ce mardi par jean-marc ayrault	0
il y a répondu personnellement et et on a continué à lui faire parvenir ce courrier	il y a répondu que personnellement euh et et on a continué à lui faire parvenir se ou pourriez être	il y a répondu de personnellement euh et on a continué à nous faire parvenir chez pourrière	1
nos nos nos notre figure de proue notre candidat jean luc mélenchon	ce nos no( notre figure de couph notre candidat euh jean-luc mélenchon	ce nos nos notres figures de coups euh notre candidat euh jean-luc mélenchon	1
il me manque une direction	maintenant qu' une direction	qu' une direction	0
et donc il s' agit d' apprécier	donc il s' agit d' apprécier	et donc euh il s' agit euh d' apprécier	0
la compagnie veut proposer des incitations financières à ses pilotes pour les faire travailler au sein de sa filiale transavia	la compagnie veut euh proposer des incitations financières à ces pilote pour les faire travailler au sein de sa filiale transavia	la compagnie veut euh proposer des incitations financières à ces pilotes pour les faire travailler au sein de sa filiale transavia	0
sur un détail la trajectoire peut être faussée	sur un détail et la trajectoire peut fausser	sur un détail euh la trajectoire peut être chusée	1
oui c' est déjà la douche froide et puis et puis les records	oui c' est la douche froide et puis et puis les records	oui c' est déjà la douche froide et puis e puis les records euh	1
à chacun son style nous c' est encore façon gangnam qu' on le préfère	chacun son style nous fait encore face au préfet	à chacun son stile nous s' est encore face au gandlam conprisle frait	0
bien alors donc le show biz avec la sortie aujourd'hui du nouvel album de gossip joyful	bien alors donc on showbize avec la sortie aujourd' hui du nouvel album euh de gossyp jo kou	bien alors donc on shobiz avec la sortie aujourd' hui du nouvel album euh de gosip joh po	1
après la remontée de nicolas sarkozy au moment de l' affaire merah	euh après la remontée de nicolas sarkozy au moment de l' affaire mera	euh après la remontée de nicolas sarkozy ou lon on ne la fermera	1
elle me paraît judicieuse attendons que monsieur gallois remette	elle me paraît judicieuse attendons que monsieur gaillois remettre son rapport	elle me paraît judicieuse attendons que monsieur gallois aurmetre son rapport	1
non seulement elle a pas diminué le millefeuille mais elle l' a augmenté en créant les métropoles	non seulement elle a pas diminué le méle chai mais elle l' a augmenté en créant les métropoles	non seulement elle a pas diminué le mélecei mais elle l' a augmenté en créant les métropoles	0
que vous ne l' ayez pas mais je le pose aux cliniques privées	que vous ne l' yiez pas mais je le pose aux clinigues privé	n' ayez pas mais je pose aux cliniques privées	1
ce qui ce qui eut été	ce qui est ce qui a été	oui ce qui ce qui eut été	0
moi je veux participer à la construction de cet avenir de l' ump	moi je veux participer à la construction de cet avenir euh de l' ump	je veux participer à la construction de cet avenir de l' ump	1
si l' on regarde dit il les engagements mirobolants de quatre vingt un quatre vingt quinze	l' on regarde dit il les engagements mirobolants de quatre vingt à quatre vingt quinze	si l' on regarde dit-il les engagements mirobolants de quatre-vingt à quatre-vingt quinze	0
je sais pas s' il était avec nous florian gazan animateur radio sur fun radio qui était vraiment	je sais pas siy étre avec nous florient gazan animateur radio sur feun de radio qui était vraiment	je sais pas s' il ést avec nous florient gazan an imateur radio sur fin de radio qui était vraiment	1
un premier grand rendez vous télévisé pour le candidat ouvrier qui finit sa prestation	un premier grand rendez-vous télévisé pour le candidat ouvrier qui finit sa prestation	premier grand rendez vous télévisé pour le candidat ouvrier qui finit sa prestation	1
pour les français pour ceux qui nous regardent	pour les français mais e ceu qui nous regarde fran ai	pour les français mais ce qui nous regardent français	0
d' ailleurs ils viennent d' annoncer leur participation mercredi à un concert en faveur des victimes de l' ouragan sandy	d' ailleurs ils viennent d' annoncer leur participation mercredi un concert et faveur des victimes de haut un consensus	d' ailleurs ils viennent d' annoncer leur participation mercredi un concert en faveur des victimes de l' ouragan son dis	0
et non d' une idéologie partisane ou syndicale	et non d' une idéologie partisane au syndical	et non d' une idéologie partisane au syndicale	0
bonsoir à tous bienvenue c' est bfm story en direct jusqu' à dix neuf heures à la une	bonsoir à tous bienvenue c' est bfm story en direct jusqu' à dix-neuf heures à	bonsoir à tous bienvenue ces bfm story en direct jusqu' à dix-neuf heures à la	1
des filles hystériques	filles hystériques	des files hystériques	1
par le passé un certain nombre de boycott d' ailleurs	euh par le passé un certain nombre de boycotts d' ailleurs	par le passé un ensemble de boycott d' ailleurs	1
les mensurations des statuettes sont rigoureusement respectées	les monsurations des statuettes sont rigoureusement respectées	l's mensuration des statuettes sont rigoureusement respectées	1
c' est quelque part il sent que les écologistes	c' est quelque part il sent euh que euh les écologistes	c' est quelque part il sent euh queeh les écologistes	1
il y a la taxe oui bon	li à la tasse oui mas	lié à la tase oui mai	1
parle déjà à l' oreillette en me disant non pas plus allez y	parle déjà à l' horeillette en me disant non pas plus allez-y	parle déjà l' oriente en disant on n' en pas plus allez-y	1
non seulement elle a pas diminué le millefeuille mais elle l' a augmenté en créant les métropoles	non seulement elle a pas diminué le mélecei mais elle l' a augmenté en créant les métropoles	non seulement elle a pas diminué le mille faille mais elle l' a augmenté en créant les métropoles	0
et oui objectif protester contre mille quatre cents suppressions de postes annoncées alors que	h oui objectif protester contre mille quatre cents suppressions de postes annoncées alors que	eh oui objectif protester contre mille quatre cents suppressions de postes annoncées alors que	0
qui fait son retour dans des jeux olympiques très discrète très pressée visiblement laure manaudou puisqu' elle a évité quasiment	uh qui fait son retour dans des jeux olympiques très discrètes très pressé visiblement laure manaudou puisqu' elle a évité quasiment	euh qui fait son retour dans des jeux olympiques très discrètes très pressée visiblement laure manaudou puisqu' elle a évité quasiment	0
à notre connaissance les dernières exportations donc c' est terminé	a notre connaissance les dernières exportations donc ça s' est terminé	à notre connaissance et les dernières exportations donc ce c' est terminé	1
elle pourrait rentrer dans un gouvernement ps	elle e en va en tre e dans e n cout e e en le en les e es pa	elle pourrait rentrer dans un gouvernement du ps pas	0
geoffroy didier guillaume peltier merci à bientôt sur bfm tv	jean froid didier guillaume peltier merci à bientôt sur bfm tv	jean-frodidier guillaume peltier merci eci bientôt sur bfmtv	1
vous savez de la justice en général on attend pas on attend pas qu' elle soit	vous savez de la justice en général on n' attend pas on n' attend pas qu' elle soit	vous savez de la justice en général on n' attend pas on n attend pas qu' elle soit	1
les plus pénalisés et puis autour de de cela et au delà même sur les sur les fonctionnaires	les plus pénalisés et puis au autour de de de cela et au-delà même sur les sur les fonctionnaires	plus pénalisés et puis au autour de de de cela et au delà même sur les sur les fonctionnaires	1
se bouffent le nez sur place	euh se boufe le nez sur place euh	euh se bouff le nez sur place euh	1
marine le pen a immédiatement exprimé son intention de saisir la justice écoutez	marine le pen a immédiatement exprimé son intention de saisir la justice éco(te)	marine le pen a immédiatement exprimé son intention de saisir la justice etc	1
et on vient tous témoigner du travail que nous avons fait avec nicolas sarkozy dont nous sommes fiers	et on vient tous euh témoigner du travail que nous avons fait avec nicolas sarkozy dont nous sommes fiers	et on vient tous témoigner du travail que nous avons fait avec nicolas sarkozy donct nous sommes fiers	0
c' était on le présente aujourd'hui comme l' un des meilleurs animateurs radio et télé de sa génération malheureusement	c' était on le présente aujourd' hui comme l' un des meilleurs animateurs radios et télé de sa génération malheureusement	c' était on le présente aujourd' hui comme l' un des meilleurs animateurs radio et télé de sa génération malheureusement	1
j moins un	j' y mois un	ji mois un	0
décortiquons cher christophe bonjour	christophe bonjour	décortiquant jacques christophe bonjour	1
avec pugnacité marie labat	avec pubnacité marie laben	avec pugnacité marie laban	0
oui alors c' est c' est un peu l' avenir	oui alors euh euh c' est c' est un peu l' avenir	oui alors euh euh c'est c' est un peu l' avenir	1
bruno le maire côté face l' ancien secrétaire d' état en charge des pme	bruno le maire côté face l' ancien secrétaire d' etat en charge des pme	bruno le marre côté face l' ancien secrétaire d' état en charge des pme	1
c' est cent dix mille suspects supplémentaires interpellés par la police	c est cent dix mille suspects supplémentaires interpellés par la police	c' es cent dix mille suspects supplémentaires interpellés par la police	1
il a suivi la	est assimilé	i je suis mis	1
je préviens le bourget pour leur dire qu' on risque de décoller en retard	je conais le bonger pour leur dire qu' on risque d être découlér ente	je ai conbien le bourger pour leur dire qu' on risque de décolér en tea	0
sur la fin sur la fin	a le sur la femme	par la fi sur la fin	0
on était au dixième rang	vous êtes en dixième ra	poun étaét au dixième rang	0
et j' ai compris très vite que que j' avais un cancer	compris très vite que je vais danser	et euh je conpris ouh très vite euh que ce que j' aimais un cancer	0
propos recueillis par thomas soulié et julia le correc j' accueille tout de suite florence muracciole bonjour	propos recueillis par thomas soulié et julian le correc j' accueille tout de suite florence muracciole bonjour	propos recueillis par thomas soulié julia le correc jacques est toute petite florence muracciole bonjour	1
le mérite de ce gouvernement critiqué dans d' autres rôles	euh le mérite de ce gouvernement vous critiquez dans votre rôle	euh le mérite de ce gouvernement vous étiquez dans d autre rôle	1
ken loach s' indigne	y a ne autre syndine	gan mo ceain dî	1
bonsoir anna cabana	bonsoir anna kabada	le canada	1
on croit encore aux jeux olympiques	quoi encore euh aux jeux olympiques	pas encore euh aux jeux olympiques	1
alors faut bien comprendre que tous les ans la la l' espagne renouvelle environ un septième de sa dette	alors euh faut bien comprendre que tous les ans euh l' e() la l() l' espagne renouvelle environ un septième de sa dette	alors euh faut bien comprendre que tous les ans euh l' e() la a l l' espagne renouvelle environ un septième de sa dette	1
il fait une bonne campagne jean luc mélenchon ce serait pas honnête de ne pas le reconnaître	il) fait de bonne campagne jean-alic mélenchon ce serait pas honnête de ne pas le reconnaître	fait une bonne campagne de jean luc mélenchon se serait pas honnête de ne pas le reconnaître	0
ensuite il faut voir quelle solution on apporte à cette difficulté là	euh ensuite il faut voir quelleles solution on apporte à cette difficulté-là	ensuite il faut voir quelles solutions on apporte à cette difficulté là	0
levez vous s' il vous plaît et puis enfin laurent neumann pour marianne bonjour	levezvous s' il vous plaît et puis enfin laurent neumann pour marianne bonjour	levnez-vous s' il vous plaît et puis enfin laurent neumann pour marianne bonjour	1
ça n' a rien à voir c' est des histoires de contrat du service public	ça n' a rien à voir c' est l' idée de compteur du service public	e vai ren avoir c' es l'ide e e e e on e e a du servi e e e pu lii	1
écoutez l' ambiance est très bonne tout le monde attend avec impatience	écoutez l' ambiance c' est très bonne tout le monsde attendton à attend avec impatience euh	écoutez l' ambiance est très bonne tout monde attenton ta attends avec impatience euh	0
bonjour christophe vous en êtes un autre	bonjour christophe vous en rez vvez un anrot	bonjour chistoche vous arrive vez en heur o	1
avec des écoutes téléphoniques à chaque fois on retrouve la même chose l' immobilier le dossier jean jé colonna	euh avec des écoutes téléphoniques à chaque fois on retrouve la même chose l' immobilier le dossier jean-ger colonna	euh avec des écoutes téléphoniques à chaque fois on retrouve la même chose l' immobilier le dossier jean ge colonna	0
du terrorisme notamment le les loups solitaires	euh du terrorisme notamment euh les les lou solitaires	euh lors du terrorisme notamment euh les les loups solitaires	0
bien alors je continue mon exemple pour y revenir parce que	alors je continue mon exemple il pourrait revenir parce que	bien alors je continuaes mon exemple j pourrai revenir parce que	0
de la mission de peillon à l' éducation nationale	la mission de peillon à l' education nationale	de la mission de payon à l' éducation nationale	1
la folie fifty cent	la folie pipe ti sèn	la folie fic ti sèn	0
écoutez c' est hamas qui a commencé à bombarder	écoutez c' est un masque a commencé à bombarder	écoutez c' est un masse qui a commencé à bombarder	0
où y a l' ambiance très agréable	où y a une ambiance euh a très agréable	oui il y a une ambiance très agréable	0
on là on va mettre une demie heure un professeur et trente enfants	on l' a on va mettre une demi-heure on va un professeur et trente enfants	on l'a on va mettre une demi-heure on va un professeur et trente enfants	0
je sais pas s' il était avec nous florian gazan animateur radio sur fun radio qui était vraiment	je sais pas s' il éait avec nous florient gazan animateur radio sur fun ne radio qui était vraiment	je sais pas s' il est avec nous florent gazan animateur radio sur fun radio qui était vraiment	0
filet de sécurité maintenu	il est de sécurité maintenu euh	filet de sécurité maintenu euh	0
a su résister à l' agressivité qui était celle régulièrement de nicolas sarkozy	euh a su euh résister à l' agressivité qui était celle régulièrement euh de nicolas sarkozy	euh a su euh résister à l' agressivité qui était celle régulièrement de nicolas sarkozy	0
vous allez nous citer gerhard schröder	vous allez nous situer euh gerhard schröder	vous allez nous cituer euh gerhard schröder	0
et cette affaire date de de la fin deux mille onze	et cette affaire date de de la fin deux milles onze	il y a cette affaire date de de la fin deux milles onze	1
mais est ce que ces entreprises françaises comme cosmos savaient comment le régime utilisait leur martel leur matériel	ai mais est-ce que ces entreprises françaises comme euh causmose savaient euh comment le régime utilisait leur marté leur matériel	et mais est-ce que ces entreprises françaises comme cosmose savaient euh comment le régime utilisait laur marté(ri() leur matériel	1
si l' on regarde dit il les engagements mirobolants de quatre vingt un quatre vingt quinze	si l' on regarde dit-il les engagements mirobolant de quatre-vingt un quatre-vingt quinze	si l' on regarde dit-il les engagements miro bolland de quatre-vingt n quatre-vingt quinze	1
pas le pas l' avis général	pas le pas l' avis géné()	pas le palais vigila	1
ce sont aussi les gouvernants ordinaires ordinairement cyniques dit il	ce sont aussi les gouvernants ordinaires ordinairement cyniques dit-il	ce sont aussi les gouvernants ordinaires ordinairement ciniques dit-il	1
contre l' euro	l' euro	contre le ro	0
henri emmanuelli dire que on va devoir travailler plus tard	enri emmanueli euh dire que on va demar paer plus tard ou deseen dee	henri emmanuelli euh dire que on va devo parelle plus tard au dée e le	0.5
nous sommes tous fiers du travail que nous avons fait avec l' ancien président de la république	euh nous sommes tous fiers du travail que nous avons fait avec l' ancien président de la république	nous sommes touche fiers du travail que nous avons fait avec l' ancien président de la république	1
pour les retraites	on les retraites	bon les retraites	0
hier les deux finalistes dans la course effrénée à la présidentielle ont abattu leurs dernières cartes	hier les deux finalistes dans la course effréée à la présidentielle ont abattu leur dernères cartes	hier les deux finalistes dans la course effreinée à la présidentielle ont abattu leur dernière carte	0
pas de mobilisation véritablement là on voit comment ça peut ça peut prendre	en)fin de mobilisation véritablement là on voit comment euh ça peut euh ça peut prendre	une fois de mobilisation véritablement là on voit comment euh ça peut euh ça peut prendre	0
le peuple de france	pas de france	le pape de france	0
mais le dossier jean jé colonna il est épais comme ça il était épais comme ça	le dossier changer colonna il est épais comme ça il était épais comme ça	mais le dossier jean-gy colonna il ést épais comme ça il était épais comme ça	0
pas le pas l' avis général	pas le pas la viinaire	pas le pas la vie génaire	0
qui pensent qu' il faut choisir pour les pour la population obtue pour les peuples obtus	qui pent qu' il faut choisir pour les pour la population opttu pour les peuples opttus	qui pensen qu' il faut choisir pour les pour la population otue pour les peuples obtus	0
au petit jeu du my tailor is rich	petit jeu du manque de talent ils jouaient chez	au petit jeu du miiggtell ezriach	0
attendez est ce qu' on peut juste parler des faits	attendez est-ce qu' on peut juste parler des f)	bais attendez est-ce qu' on peut juste parler des	1
ont fait la démonstration que ils avaient	ont fait la démonstration que euh ils avaient euh	on fait la démonstration que ils avaient euh	1
puis les candidats speak t il english	puis les candidat spektey inglisch	puis les candidats spicktil inglich	0
des fans prêtes à tout pour revoir leur star favorite	des fannes prêtes à tout pour revoir leur star favorite	des femmes prête à tout pour avoir leurs stars favorites	1
marine le pen a immédiatement exprimé son intention de saisir la justice écoutez	marine le pen a immédiatement exprimé son intention de saisir la justice etc	marine le pen a immédiatement exprimé son intention de saisir la justice éco(te)	0
donc c' est c' est là ou ou anne parle de récit	donc c' est c' est c' est là où où euh anne parle de récit	donc c' est c' est c' est là où euh on ne parle de récit	1
et et il consacre sa une à nicolas sarkozy pas mal	et el con ça que ça une à nicolas sarkozy pas mal	consacre sa une à nicolas sarkozy pas mal	0
des fans qui vont avoir des haut le coeur	des fens qui vont avoir des haut de coeurs	des femmes qui vont avoir des hauts le coeur	1
il va être déposé	va être déposée	il va être dépo(sé)	0
je préviens le bourget pour leur dire qu' on risque de décoller en retard	je com bien le bourgé pour leur dire quoi on risque de décoller en pas	je ai conbien le bourger pour leur dire qu' on risque de décolér en tea	1
bonjour à tous et bienvenue dans lcp actu nous sommes le lundi vingt six novembre voici les titres	bonjour à tous et bienvenue dans lcpactu nous sommes le lundi vingt six novembre voici les titres	bonjour à tous et bienvenue dans lcpe actu nous sommes le lundi vingt six novembre voici les titres	1
si c' est	si	je suisse	1
bfm tv dix huit heures bonsoir rachid m' barki	bfm tv dix-huit heures bonsoir hachid n barki	bfm tv dix-huit heures bonsoir rachidne barki	1
pourtant en coulisses c' est bel et bien l' après présidentielle qui se jouait en seine et marne	pourtant aux coulisses c' est bel et bien l' après présidentielle qui se jouait en seine-et-marne	pourtant au coulisse c' est bel et bien l' après présidentielle qui se jouait en scèine et marne	1
c' est ce que vous dîtes elle est pas efficace	c' est ceque vous e dites elle et pas efficace	c' est ce que vous dites elle est pas efficace	0
soit on s' écoute à tour de rôle soit on se coupe la parole	suoi on s' écoute un tour de rôle j soit on se coupe la parole	c' est que vous êtes un tour de rôle je pense coupe la parole	1
des éditions hugo et compagnie et puis avec vous avec nous virgile caillet bonsoir vous êtes directeur de kantarsport	éditions hugo et compagnie et puis avec vou() vous e avec nous virgile caillet bonsoir vous êtes euh directeur de cantar sport	éditions hugo et compagnie et puis avec vous vous avec nous virgile caillet bonsoir vous êtes euh directeur de cantar sport	0
au delà de ça bien sûr j' aurais aimé qu' il soutienne l' écologie politique au delà	au-delà de ça bien sûr j' aurais aimé euh qu' il soutiennen l' écologie politique au-delà	au-delà de ça bien sûr j' aurais aimé euh qui soutienne l' écologie politique au-delà	1
par rapport à l' antenne	par rapport à l' angtenne	bon à long terme	1
heureusement qu' on l' a beaucoup réduit	donc de chmbre qu on l' a beaucoup réduit	donc le chande on l' a beaucoup réduit	1
nous sommes lassés des moulinets estivaux de monsieur montebourg	nous sommes enacés de les mouliners et estivaux de monsieur bontbourg	nous sommes lassés des moulinets et estivaux de monsieur montebourg	0
non mais j' ai pas dis ça	non mais j' ai pas de ça	non mais j' ai pas dit ça	0
je ferai je ferai cent pour cent de ce que nous déciderons collectivement de faire	je ferais je ferais euh cent pourcent de ce que nous déciderons collectivement de faire	je ferais je ferais euh cent pour cent euh ce que nous déciderons collectivement de faire	1
huit mille relayeurs se sont succédé depuis et depuis quelques jours elle fait le tour des quartiers de londres	huit milles relaeurs se sont euh succédées depuis et depuis quelques jours elle fait le tour des quartiers de l' omdres	huit milles relaeurs se sont euh succédés depuis et depuis quelques jours elle fait le tour des quartiers de londres	0
françois hollande est en tête au premier tour à trente pour cent et gagne	hollande est en tête au premier tour à trente pour cent et gagne	françois hollande est en tête au premier tour à trente pourcent et gagne	0
il est pas encore tombé il il vacille il vacille mais il est pas encore sur le point de tomber	est pas encore tombé voici bercy mais	il est pas encore tombé il est il vacille euh il vacil mais il est pas encore venu tombé	0
quand même pas ils sont venus me voir il y a trois semaines	o canm ba ils sont venus me voir il y a trois semaines	o ils sont venus me voir il y a trois semaines	0
et on voit aujourd'hui où se trouve la grèce alors justement est ce que c' est un business rentable	et on voiteu aujourd' hui ou se trouve la graisse alor justement est-ce que c' est un business rentable	on voit aujourd' hui on se trouve la grèce euh justement si le c' est un businesse fontable	1
on parle beaucoup aussi bien sûr de laure manaudou	on parle beaucoup aussi bien sûr de leur ma	on parle beaucoup aussi bien sûr de l' aure manoudou	0
la compétitivité de l' allemagne s' est faite de façon intra européenne	la compétitivité de l' allemagne s' est faite de façon intraeuropéenne	la compétitivité de l' allemagne c' est faite de façon intra européenne	1
et plus surprenant lady gaga	et le plus surprenant lestis gaga	est plus surprenant e lai di daga	1
c' est la première fois que que l' ump est dans l' opposition depuis sa création	c' est c' est la première fois que que l' ump est dans l' opposition depuis sa création	et c' est la première fois que que l' ump est dans l' opposition depuis sa création	0
après les manifestations de policiers le gouvernement jospin avait mandaté deux parlementaires pandraud caresche	après les manifestations de policiers le gouvernement jospin avait mandaté deux parlementaires pandro carech	les manifestations de policiers le gouvernement jospin avait mandaté deux parlementaires pandraud caresche	1
la compagnie aérienne propose à ses pilotes de travailler pour sa filiale low cost transavia	la compagnie aérienne propose à ses pilotes de travailler pour s' a filiale locauste transavia	la compagnie aérienne propose à ses pilotes de travailler pour sa filiale locust transavia	0
réduire la la compétitivité uniquement aux coûts salariaux	réduire la la compétitivité euh uniquement aux coût salariaux	réduire la la compétitivité euh uniquement baucoup salariaux	1
huit mille relayeurs se sont succédé depuis et depuis quelques jours elle fait le tour des quartiers de londres	huit milles relaeurs se sont euh succédés depuis et depuis quelques jours elle fait le tour des quartiers de londres	huit milles relaeurs se sont euh succédées depuis et depuis quelques jours elle fait le tour des quartiers de l' omdres	1
où se réunissent ce soir et demain l' association des des amis de nicolas sarkozy	se réunissent ce soir et demain l' association des des amis de nicolas sarkozy	où se réunissent ce soir et demain l' association des des amis nicolas sarkozy	0
il y avait pas ces soucis avant	est c' est le souci avant	' est pas c' est fa usi avant	1
elle me rappelle par certains à certains égards celle de ma campagne de deux mille sept	elle ne rappelle par certains à certains égards celle de de a campagne de deux mille sept	elle me rappelle par certains à certains égards celle de de ma campagne de deux milles sept	0
qualifier que comme perdant	qualifique comme perdant	qualfié que comme perdant	0
vous vous et vous vous aimez la cuisine vous êtes vous coulée dans ce rôle très facilement	vous et vous aimez la cuisine vous êtes dans ce rôle très facilement	vous vous aiz) vous vous aimez la cuisine vous êtes euh coulé dans ce rôle euh très facilement	0
je vous en prie le président vous attend	puis vous en prix lu président vous attend	j'' ai vous en prix le président vous attend	0
elle sera partie dans les sables comme d' autres avant elle	sera partie dans les sables comme d' autres avant elles	sera parti dont les sable comme d' autres avant elle	1
ça s' améliore	c' est-à-dire	ça ser améliore	0
et pourtant dans une autre vie stefano sollima était journaliste désormais le voilà réalisateur et un grand	et pourtant dans une autre vise stéphano-soline a été journaliste désormais le voilà réalisateur et un grand	pourtant dans une autre vie stefano folli m' a été journaliste désormais le voilà réalisateur est un grand	1
le mérite de ce gouvernement critiqué dans d' autres rôles	euh le mérite de ce gouvernement vous étiquez dans d autre rôle	euh le mérite de ce gouvernement vous critiquez dans votre rôle	0
une décision qui satisfait breivik ce dernier craignait que l' internement psychiatrique ne discrédite ses actes	une décision qui satisfait brevic ce dernier craignait que l' internement psychiatrique ne discrédite ses actes	une décision qui satisfait brevik ce dernier craignait que l' internement psychiatrique ne discrédite ces actes	1
les bonnes décisions après les réponses de mittal	les bonnes décisions après les réponses de mithal	les bonnes décisions après les réponses de mital	0
qu' elle a même été embauchée par eddie barclay comme secrétaire trilingue	qu' elle a même été embauchée par édy barqueley comme secrétaire t trillingue	qu' elle a même été embauchée par aidy barklay comme secrétaire trilingu	1
si étonnement absente de la campagne électorale	si étonamment absente de la campagne électorale	si étonnamment absente de la campagne électorale	0
plus proche aussi de la pop internationale	le proche aussi de la pop internationale	plus proche aussi de la propre internationale	1
c' est pas si simple à utiliser	mais c' est pas si simple à utiliser	je ne sais pas si simple utiliser	1
nous sommes tous fiers du travail que nous avons fait avec l' ancien président de la république	nous sommes touche fiers du travail que nous avons fait avec l' ancien président de la république	euh nous sommes tous fiers du travail que nous avons fait avec l' ancien président de la république	0
approche de paris vous êtes bien ralenti sur l' a12 entre guyancourt et rocancourt	proche de paris vous êtes bien ralenti sur la douze entreguilles en cours et au concours	proche de paris vous êtes bien ralenti sur la douze entre nuit en courts et rau cancourt	0
voilà bon week end dans l' immédiat et à très bientôt	voilà euh bon week-end dans l' immédiat et a très bientôt	voilà euh bon week-end dans l' immédiat et à très bientôt	0
sarkozy et on a limite quoi qu' il dise actuellement ça ne passe pas sauf ceux naturellement qui sont	sarkozy a en la limite quoi qu' ils dise actuellement ça ne passe pas tout naturellement qu qui sont	sarkozy y an en a limite quoi qu' ils disent actuellement ça ne passe pas souss naturellement qui sont	1
ça vaut pas cinquante centimes non c' est pas ça	pas cinquante centimes non c' est pas ça	n ba vrai quant en dit maion c' est pas ça	1
effectivement à côté du jeu politique et donc il est et c' est de la situation idéale	effectivement à côté du jeu politique et donc euh il est c' est de la pro situation idéale	effectivement à côté du jeu politique et donc euh il est et c' est de la protitu idéale	1
il y a des massacres en syrie une situation dramatique	euh il y a des massacres en syrie une situation dramatique	euh il y a des massacreseh en syrie une situation dramatique	1
et la gare de saint pancras qui marque la fin de la grande transhumance des athlètes français un gros contingent	il y a la garde saint-ancrase qui marque à la fin de la grande transhimance des athlètes français un gros contingent	h yan lagarde saintpancraz qui marque la fin de la grande transimanance des athlètes français un gros contingent	1
il nous a semblé	nous a semblé	assemblée	1
parce que tous les deux sarkozy comme hollande avaient la	que tous les deux sarkozy comme henlande avait la	e tous les deux sarkozy comme hollande avait la	0
c' est vrai que il manque sur le soutien il y a besoin d' une écologie forte	euh c' est vrai que il manque sur le soutien il y a besoin d' une écologie forte	c' est vrai que il manque sur le soutien il y a besoin d' une écologie fort	1
qui était fébrile peu sûr de lui	était fébrile peu sûr de lui	qui était fébrile peu sûrre de lui	0
coincée un peu	coincer un peu	coincé un peu	0
possible l' agence moody' s a placé hier soir ces pays sous perspectives négatives	possible l' agence moodiz a placé hier soir ses pays sous perspective négative	possible l' agence m moj s a placé hier soir ces pays sous perspective négative	1
renaud laure manaudou ne sait pas fait tatouer sur le corps un papillon un lézard ou un marsupilami	euh renauld laure manaudou ne s' est pas fait d tatouer sur le corps un papillon un lésard ou un marchupilami	euh renaud laure manaudou ne s' est pas fait tatouer sur le corps un papillon un lésar ou un mar suupil ami	0
ce soir sur lcp avec le meeting de philippe poutou à la halle carpentier à paris	euh ce soir sur euh lcp avec le meeting de philippe poutou ala al carpentie à paris	euh ce soir sur euh lcp avec le meeting de philippe pouteou à la alcarpenti à paris	1
merci beaucoup d' être sur le plateau de bfm tv bonsoir danièle delpeuch	merci beaucoup d' aider sur plateau de bfm tv bonsoir daniel delpeux	merci beaucoup d' être sur le plateau de bfm tv bonsoir danielle delpeux	0
alors on on a en souvenir pékin bien entendu c' était politique mais alors londres	alors on en souvenir pékin bien entendu c' était politique mais alors londres	euh alors on on a en souvenir euh pékin bien entendu c' était politique mais alors londres	0
oui oui ça je suis assez d' accord parce que c' est il faut mesurer les choses quand les	oui ça fait assez d' accord parce que euh c' est il faut mesurer les choses quand les	oui oui ça chuis assez d' accord parce que c' est il faut mesurer les choses quand les	0
nos artistes qui font du cirque pour la bonne cause	artistes qui font du cirque pour la bonne cause	nos artistes qui font du sière pour la bonne cause	1
il nous a semblé	assemblée	i nous a semblé	0
a su résister à l' agressivité qui était celle régulièrement de nicolas sarkozy	euh a su euh résister à l' agressivité qui était celle régulièrementh de nicolas sarkozy	euh a su euh résister à l' agressivité qui était celle régulièrement euh de nicolas sarkozy	0
qu' elle vit dans un château et je rappelle l' origine de ce château elle c' est une héritière	que' vit à saint château et je rappelle l' origine de ce château elle c' est une héritière	qu' elle vit das son château et je rappelle l' origine de ce château et l( c' est une héritière	0
oui pourquoi pas ça peut donner des vocations	oui pourquoi pas ça ponnait une évocation	oui pourquoi pas ç' est peu donune évocation	1
coûtent les dépenses de santé chaque année il y aura des objectifs de dépenses qui seront fixés chaque année	coûte les dépenses de santé chaque année il y aura des objectifs de dépenses euh qui seront fixés chaque année	coûte les dépenses de santé chaque année il y aura des objectifs de dépense qui seront fixées chaque année	0
eddy merckx de de tout temps on a eu des dominateurs dans le peloton des des grands champions	et di merx euh en de de tous temps on a eu des dominateurs dans le peloton des des grands champions	et dy merx euh de de tous temps on a eu des dominateurs dans le peloton des des grands champions	0
pour aller tout droit dans la direction annoncée ou est ce qu' il va continuer à tirer des bords	aller tout droit dans la direction annoncée ou est ce qu' il va continuer à tirer des bords	pour aller tout droit dans la direction annoncée ou est-ce qu' il va continuer à tirer des bords	0
son énergie sa sa pêche son son intelligence	son énergie sa sa pêche son son intelligence euh	l' énergie sa sa pêche son son intelligence	1
d' accord avec ça danielle schweisguth	euh d' accord avec ça danieèle lachosegou	d' accord avec ça euh danièl schosgoud	0
il fait une bonne campagne jean luc mélenchon ce serait pas honnête de ne pas le reconnaître	fait une bonne campagne de jean luc mélenchon se serait pas honnête de ne pas le reconnaître	il) fait de bonne campagne jean-alic mélenchon ce serait pas honnête de ne pas le reconnaître	1
l' ensemble des forces qui consitue le front de gauche	euh l' ensemble des forces qui constitue le front de gauche	euh l' ensemble des forces qui constituent le front de gauche	1
il fait une bonne campagne une une campagne de de mobilisation	euh il fait une bonne campagne une une campagne de de mobilisation	il fait une bonne campagne une campagne de mobilisation	0
plus le temps passe plus on s' enfonce dans les mensonges	le temps passe plus on c' en fonce dans les mensonges	enfin on s' enfonce dans les mensonges	1
une nouvelle expo tim burton	au nouvel expo ting burton oui	nouvelle expo tim	0
qui est un aciériste un industriel qui n' est pas un financier	est un aciéristes un industriel qui n' est pas un financier	qui est un assiériste un industriel qui n' est pas un financier	1
sarkozy et on a limite quoi qu' il dise actuellement ça ne passe pas sauf ceux naturellement qui sont	sarkozy y an en a limite quoi qu' ils disent actuellement ça ne passe pas souss naturellement qui sont	sarkozy a en la limite quoi qu' ils dise actuellement ça ne passe pas tout naturellement qu qui sont	0
nicolas hulot le perdant de la primaire europe écologie les verts refuse	nicolas hulot le perdont de la primaire europe écologie les verts refuse	nicolas hulot le perdant de la primaire europe ecologie les verts refuse	0
il nous a semblé	qui nous a semblé	assemblée	1
chercher une surinterprétation au delà de ce simple	chercher une sur interprétation au-delà de ce simple	chercher une sur-interprétation au-delà de ce simple	0
c' est la compétition en fait	abutition en fait	laiction en fait	0
porter atteinte à la sécurité de la libye porter atteinte à l' amitié entre la france et la libye	porter atteinte à la sécurité de la libye porte atteinte à l' amitié entre la france et la libye	portée atteinte à la sécurité de la libye portée atteinte à l' amitié entre la france et la libye	1
j' apprends tellement de choses catherine avec vous je vous regarde	je aprends tellement de choses que le vile avec vos vo vête garde	j' apprends tellement de choses que j ril avec vo vou dete garde	0
le président ne sera pas là avant dix minutes	le président na sera pas là vant timiné	le président ne sera pas là vont diminuer	0
honoré au festival lumière le réalisateur qu' on sait engagé en a profité pour se révolter	honoé au festival lumière le réalisateur conait engagé en a profité pour se révolter	honorée au festival lumière le réalisateur conçait engagé en a profité pour se révolter	0
a exfiltré son mari vers le maroc où elle l' a	a expiltreré son mari vers le maroc où elle l' a	a exfiltré son mari vers le maroc où elle la	0
alors est ce que c' est pas facteur de zizanie de discorde au sein d' un mouvement	alors est-ce que c' est pas n facteur de zizanie de discorde au sein d' un mouvement	est ce que c' est pas un facteur de zizanie de discorde au sein d' un mouvement	1
madame vers nous	madame bernau	madame ernaude	1
que pour revenir à l' équilibre il faut	que pour revenir à l' équilibre i(l) fa	pour revenir à l' équilibre ifa	1
le clip de l' apocalypse	le cit de l' apocalype	le cype de l' apocalypse	0
si c' est	civi	si	0
oui mais ce qui est amusant c' est qu' ils y pensent maintenant c' est à dire	oui mais ce qui est amusant c' est qu' ils y pense maintenant c' est-à-dire	oui mais ce qui est amusant c' est qu' il n' y pense maintenant c' est à dire	1
ça n' a rien à voir c' est des histoires de contrat du service public	ça n' avait rien à voir c' est l' idée au compteur a du service public	de a e von e a voir c' es es e e o e on er a du service e e a e	1
après quelques jours de cavale c' est aujourd'hui que les autorités espagnoles les ont extradés vers la france	après quelques jours de caval euh c' est aujourd' hui que les autorités espagnoles les ont extradés vers la france	après quelques jours de cavale euh c' est aujourd' hui que les autorités espagnoles les ont extradées vers la france	0
pas le pas l' avis général	pas le pas la vie génaire	pas le pas la viinaire	1
il avait c' était un énorme bosseur jean luc il faut il faut pas oublier ça il était	avez vous c' est un énorme bosphore jean louis qu' il faut il faut pas oublier ça il était	vous savez c' est un énorme boxeur jean louis qui faut il ne faut pas oublier ça il était	0
qui existait de basculer le montant non utilisé du crédit collaborateur sur l' irfm sera supprimée	qui existait de basculer le montant non utilisé du crédit collaborateur sur l'fm sera supprimé	qui existait de basculer le montant non utilisé du crédit collaborateur sur l' rfm sera suprimé	0
par les entreprises à zéro un pour cent	par les entreprises à zéro un pourcent	les entreprises à zéro un pour cent	1
il y a une résignation alors y a des manifestations mais est ce que y a un plan b	il y a une résignation alors il y a des manifestations mais est-ce que il y a un plan bé	est une résignation alors il y a des manifestations mais à ce que il y a un plan b	1
oui ce sont les cuisiniers des vingt cinq chefs d' état les plus puissants du monde	oui ce sontuh les cuisiniers des vingt cinq chefs d' état les plus puissants du monde	oui ce sont euh les cuisiniers des vingt cinq chefs d' état les plus puissants du monde	0
deux mille un	deux milles an	deux milles un	0
la compagnie veut proposer des incitations financières à ses pilotes pour les faire travailler au sein de sa filiale transavia	la compagnie veut euh proposer les incitations financières à ses pilotes pour les faire travailler au sein de sa filiale transabia	la compagnie veut euh proposer des incitations financières à ses pilotes pour les faire travailler au sein de sa filiale transaviable	1
parce que sinon ils vont franchir un seuil et que c' est des obligations supplémentaires supprimons ces obligations	parce que sinon ils vont franchir un seuil et que cest des obligations supplémentaires supprimons ces obligations	parce que sinon ils vont franchir un seuil et que c' est des obligations supplémentaires supprimeront ces obligations	0
leur une pour les prochaines semaines et consacreront leur choix à à jean luc delarue bien sûr	àuh leur une pour les prochaines semaines et consacront leur char à la r() à jean-luc delarru bien sûr	à leur une pour les prochaines semaines et consacrons dans choix alors là jean-louis delarue bien sûr	0
la culture et la compétence de peillon	la culture et la compétence de payon	culture et la compétence de payant	1
elle me rappelle par certains à certains égards celle de ma campagne de deux mille sept	elle me rappelle par certains euh à certains égards celle de de la campagne de deux milles sept	elle ne rappelle par certains à certains égards celle de de a campagne de deux mille sept	1
rassemblant rassurez vous il y en a chez vous	rassemblant rassurez-vous il y en a chez vous	rassurez vous il y en a giroud	1
soit on s' écoute à tour de rôle soit on se coupe la parole	soit on s' écoute un tour de rôle soit on se coupe la parole	suoi on s' écoute un tour de rôle j soit on se coupe la parole	1
et on voit aujourd'hui où se trouve la grèce alors justement est ce que c' est un business rentable	et on voiteu aujourd' hui ou se trouve la graisse alor justement est-ce que c' est un business rentable	on voit eu e fran en e es le eu ous se trou le le re se e le juste ment se le c es un das es ren table	1
pas que je mélange tout c' est l' exacte vérité	que je mélange tout c' est l' exacte vérité g	pas que je mélange tout c' est l' exacte secérité	0
à buckingham palace au couple princier william et kate et ça sera un événement que vous pourrez suivre là aussi	un buckingham palace au couple princier william e ket et ça sera un événement ce que vous pourrez suivre là aussi	un buc kigam palace au couple princier willam et kaït et ça sera un événement que vous pourrez suivre là aussi	1
trop généreuse pour certains ça c' est une conviction personnelle je sais qu' elle fait l' objet de débats	trop généreuse pour certains ça c' est une conviction personnelle je sais qu' elle fait l' objet de débat	trop généreuse pour certains ça c' est une conviction personnelle je sais qu' elle fait l'objet de débat	0
ça s' améliore	s' améliorent	ça c' est améliore	0
mais c' est vos	mais c' est beau(	mais c' est vous	0
le chiffre était	le chiffre de tou les	le cee ou e e	1
on disait c' est une marque vieillissante un peu datée ils font des voitures maintenant formidable la ds3 la ds4	euh on disait c' est une marque vieillisseante un peu datée il font des voitures maintenant formidable la dstroi à la dsk	euh on disait c' est une marque vieillissante un peu datée ils font des voitures maintenant formidables la ds trois la ds quatre	0
le chiffre était	le chefouteele	le chiffre ou était	0
un ciné rapido	un ciné rapideau(	un cilet rapide	1
on là on va mettre une demie heure un professeur et trente enfants	on l'a on va mettre une demi-heure on va un professeur et trente enfants	on l' a on va mettre une demi-heure on va un professeur et trente enfants	1
sarkozy et on a limite quoi qu' il dise actuellement ça ne passe pas sauf ceux naturellement qui sont	sarkozy y an en a limite quoi qu' ils disent actuellement ça ne passe pas souss naturellement qui sont	sarkozy y e en alimique quoi qu' il dise actuellement ça ne passe pas sous se naturlement qui sont	1
j moins un	j' ai moins un	j' y mois un	0
et puis voilà après c' est c' est aux électrices et aux électeurs de ce pays	et puis voilà après ces faits aux électrices et aux électeurs de ce pays	et puis euh voilà après c' est c' est aux électrices c' est aux électeurs de ce pays	0
et découverte de films rares il s' est improvisé choriste	et découverte de films rares et ill s' est encore visé cooriste	ils découvertent deux films rares il s' est improvisé ethoriste	1
on a eu alain bernard on a camille lacourt yannick agnel et d' autres et en même temps	euh on a eu alain bernard euh on a euh camis la cour y an ny canyadet d' autres et en même temps	euh on a eu alain bernard euh on a euh camille la cour et une camion des d' autres et en même temps	0
après la grande famille il montait dans son bureau	après la grande famille il montai dans son bureau	après la grande famille i(l) monta dans son bureau	1
j moins un	j' y mois un	j' ai moins un	1
ils se disputeront des médailles dans trois cent deux épreuves devant un parterre impressionnant de spectateurs	ils se disputeront des médailles dans trois cents deux épreuves devra partaire impressionnant de spectateurs	ils se disputeront des médailles dont trois cents deux épreuves devant à part ter impressionnant de spectateurs	1
à dix neuf heures trente dans une petite heure maintenant william and kate avec la flamme à buckingham palace	a dix neuf heures trente dans une petite heure maintenant william nk7 avec la flamme à buckingham palace	à dix-neuf heures trente dans une petite heure maintenant william ankeitt avec la flamme à bukingham palace	0
on était bien meilleur qu' eux	on était bien meilleur que	on était bien meilleilleurs qu' eux	0
oui pourquoi pas ça peut donner des vocations	oui pourquoi pas ça peu donner de vocation	pourquoi pas ça peut donner des vocations	0
à mis un temps fou à se constituer	euh a mis un temps vous à se constituer	euh a mis un temps de fou à se constituer	0
et puis voilà après c' est c' est aux électrices et aux électeurs de ce pays	et puis euh voilà après c' est c' est aux électrices c' est aux électeurs de ce pays	et puis voilà après ces faits aux électrices et aux électeurs de ce pays	1
qu' est ce qu' ils ont défendu les classes les plus riches	qu' est-ce qu' ils ont défendu les classes les plus riches	est ce qu' ils ont défendu les classes les plus riches	1
florence alors à la une des hebdos anne lauvergeon sans état d' âme	florence no rog alors à la une des hebdos anne lauvergon sans états d' âme	bougies alors à la une des hebdos anne lauvergeon sans états d' âme	1
huit mille relayeurs se sont succédé depuis et depuis quelques jours elle fait le tour des quartiers de londres	mille relayeurs se sont succédé depuis depuis quelques jours elle fait le tour des quartiers de londres	huit milles relayeurs se sont euh succédés depuis et depuis quelques jours elle fait le tour des quartiers de londres	0
on est quand même beaucoup plus tranquille	on est quand même euh beaucoup plus tranquille	on est quand même euh beaucoup plus tranquilles	1
si jean luc mélenchon n' est pas le le troisième homme dimanche est ce que ce sera une déception	si jean-luc mélenchon euh n' est pas le le troisième homme dimanche est-ce que ce sera une déception	si jean-luc mélenchon euh n' est pas le le troisième homme dimanche est-ce que ce serai une déception	1
on voit dans les rues il y a de plus en plus de monde	on le voit dans les rues il y a de plus en plus de monde	voit dans les rues il y a de plus en plus de monde	1
je sais pas s' il était avec nous florian gazan animateur radio sur fun radio qui était vraiment	je sais pas s' il ést avec nous florient gazan an imateur radio sur fin de radio qui était vraiment	je sais pas siy étre avec nous florient gazan animateur radio sur feun de radio qui était vraiment	0
ensuite est ce qu' il va pouvoir violer son caractère profond	ensuite est-ce qu' i(l va pouvoir euh eu violer son caractère profond	ensuite est-ce qu' il va pouvoir euheuh violer son caractère profond	0
pas étalé dans le dans la presse	pas est allé dans la dans dans la presse euh	est allé dans le dans dans la presse	1
bonsoir à tous bienvenue c' est bfm story en direct jusqu' à dix neuf heures à la une	à tous bienvenue c' est bfm story en direct jusqu' à dix neuf heures	bonsoir à tous bienvenue c' est bfm story en direct jusqu' à dix-neuf heures à	0
le le la table avec ses médicaments qui jouxtait sa qui jouxtait son lit je le revois encore regardant	le le l' attaque d' un effet uniquement qui s' occupaient ça euh qui oublie s' enlis euh i(ls) je le revends encore au gardant euh	une table avec ces médicaments qui jouxte sa qui toute cette folie je me revois encore regardant	0
deux mille sept deux mille douze on voit que ces campagnes de facilité	mille sept deux mille douze on voit que ces campagnes de facilité	deux milles sept deux milles douze on voit que ces campagnes de facilité	0
et de la fortune et du parti elle ne vient pas de nulle part	et de la fortune et du parti tout elle ne vient pas de nulle part	et de la fortune du parti elle ne vient pas de nulle part	1
il a suivi la	i je suis mis	est assimilé	0
à des moments où il devrait le faire je pense notamment à la libération de florence cassez par exemple	à des moments où il devraint le faire je pense notamment euh à la libération de florence cassé par exemple	à des moments où ils devrait le faire je pense notamment euh à la libération de florence cassé par exemple	0
si l' on regarde dit il les engagements mirobolants de quatre vingt un quatre vingt quinze	si l' on regarde dit-il les engagements mirobolants de quatre-vingt à quatre-vingt quinze	l' on regarde dit il les engagements mirobolants de quatre vingt à quatre vingt quinze	1
êtes vous sûr que ce gagnant va rester en france avec les impôts	etes vous sûr que ce gagnant va rester en france avec les impôts	êtes-vous sûr que ce gagnant va rester en france avec euh les impôts	1
claude vous voulez me parler de	claude vous voulez me parler de de	claude vous alulez me parlez de de	1
ce qui se passera après alors c' est ainsi que selon l' express le nom de	euh ce qui se s() pa() sera après alors c' est ainsi que selon l' express le nom de	euh ce qui s() s() pas) sera après alors c' est ainsi que selon l' express le nom de	1
merci andré paccou dominique rizet manuel valls dit le sport l' immobilier	andré pachoux dominique frisait manuel valls dit le sport l' immobilier	merci à andré pacou dominique rizet manuel valls dit le sport l' immobilier	0
très très mal supporté une grand mère qui qui qu' il vénérait et enfin	euh très très mal supporté une grand-mère qui qui qui l) qui le vénérer enfin	euh très très mal supporté une grand-mère qui qu'i qu' il qu' il vénérait enfin	0
mais franchement vous	un meuffrage oumeur	on mais franchement	0
des éditions hugo et compagnie et puis avec vous avec nous virgile caillet bonsoir vous êtes directeur de kantarsport	édition hugo est compagnie et puis avec v() vous avec nous virgille caillet bonsoir vous êtes le directeur de cantar sport	éditions hugoot et compagnie et puis avec v vous et avec nous virgile cayer bonsoir vous êtes directeur de canant à res sport	1
taubira garde des sceaux ministre de la justice	obira garde des sceaux ministre de la justice	(sobira garde des sceaux ministre de la justice	1
aussi les collectivités la csg ne touche que les ménages que les français qui travaillent ou qui sont retraités	aussi les collectivités la csg ne touche que les ménages que les français qui travaillent ou qui sont en retraités	si les collectivités la csg ne touche que les ménages que les français qui travaillent ou qui sont retraités	1
des filles hystériques	des files hystériques	filles hystériques	0
une nouvelle expo tim burton	au nouvel expo ting burtom	nouvelle expo team	1
places à vendre	la savendre	ça vendre	0
à mille huit cent cinquante euros brut	mille huit cents cinquante euros brut	à mille huit cents cinquante euros euh brut	0
et eux aussi entrent dans cette logique de haine alors qu' ils sont censés la combattre	et eux aussi entre eux dans cette logique de hain alors qu' ils sont sensés la combattre	oscillent entre dans cette logique de haine alors qu' ils sont censés la combattre	1
et tous deux vous êtes membres de l' association les amis de nicolas sarkozy	et tous deux vous êtes membres de l' association des amis nicolas sarkozy	et tous deux vous êtes mon de l' association des amis nicolas sark	1
pas le pas l' avis général	pas le palais vigila	pas le pas l' avis géné()	0
donc on va on va le laisser vous répondre	donc on va on va le laisser vos réponde	donc on va on va le laisser vos répondres	0
une réunion d' enfants de la chiraquie avec pour ambition la présidentielle de deux mille dix sept	une réunion d' enfants de la chiraquie avaient pour ambition la présidentielle de deux mille dix sept	une réunion d' enfants de la chiraquie avec pour ambition la présidentielle de deux milles dix-sept	0
ces réformes structurelles vous les abandonnez personnellement je le regrette beaucoup	ces réformes structurelles vous les abandonner personnellement je le regrette beaucoup	ces réformes structurelles vous les abandonnes personnellement je le regrette beaucoup	1
si jean luc mélenchon n' est pas le le troisième homme dimanche est ce que ce sera une déception	si jean-luc mélenchon euh n' est pas le le troisième homme dimanche est-ce que ce serai une déception	si jean-luc mélenchon euh n' est pas le le troisième homme dimanche est-ce que ce sera une déception	0
comment il s' appelle	il s' appelle	apple	1
les mensurations des statuettes sont rigoureusement respectées	l's mensuration des statuettes sont rigoureusement respectées	les monsurations des statuettes sont rigoureusement respectées	0
il nous a semblé	assemblée	qui nous a semblé	0
par le passé un certain nombre de boycott d' ailleurs	par le passé un ensemble de boycott d' ailleurs	euh par le passé un certain nombre de boycotts d' ailleurs	0
on là on va mettre une demie heure un professeur et trente enfants	on l' a on va mettre une demi-heure on va un professeur et trente enfants	là on va mettre une demi heure au vent un professeur et trente enfants	1
à mis un temps fou à se constituer	euh a mis un temps fou à se constituer	euh a mis un tarp e fond à sé ronstitué	1
parce que tout va aller très vite	parce que tout le mari est très bien	parce que tout va arriler très vite	0
ça leur fait un coup de pub très intéressant	ça leur fait un coup de pub très intéressan	ça leur fait un coup de pube très intéressant	1
avec pugnacité marie labat	avec pugnacité marie laban	avec pubnacité marie laben	1
mais qui risque demain d' avoir des difficultés pour l' entreprise ou autre	mais qui risque demain d' avoir des difficultés pour l' entreprise et hautre	mais qui risque demain d' avoir des difficultés pour l' entreprise de hautre	1
et un méchant campé par javier bardem drôle et flippant à la fois	et un méchant campé par ravier bardel drôle et flippant à la fois	et un méchant campé par javièr bardem drôle et flipant à la fois	0
en tirer les conclusions mais je je trouve cette	euh en tirer des conclusions mais j je trouve cette euh	euh en tirer les conclusions mais je je trouve cetteuh	1
la culture et la compétence de peillon	culture et la compétence de peillon	la culture et la compétence de payon	1
et on voit aujourd'hui où se trouve la grèce alors justement est ce que c' est un business rentable	on voit eu e fran en e es le eu ous se trou le le re se e le juste ment se le c es un das es ren table	et on voit aujourd' hui où se trouve la grèce alors justement est-ce que c' est un business rentable	0
bonsoir anna cabana	le canada	bonsoir alain cabada	0
je sais pas s' il était avec nous florian gazan animateur radio sur fun radio qui était vraiment	je sais pas s' il ést avec nous florient gazan an imateur radio sur fin de radio qui était vraiment	passy est avec nous florian gazons animateur radio sur fun radio qui était vraiment	1
infléchi ou est ce qu' il a	ici ou est ce qu' il a	unen fléchi ou est-ce qu' il a	0
le travail du ministre de la justice était de préparer un texte complétant	le travail du ministre de la justice c ett-être préparé à un texte complétent	le travail du ministre de la justice est aitre préparer un texte compétent	1
ils ont réussi à monter en gamme regardez les vins du languedoc roussillon	i(l)s ont réussi à monter en garde regardez les vins du dong doc roussillon	i(ls ont réussi à monter en gamme regardez les vingt du languedoc-roussillon	0
s' il vous	z il vous	tezl vos	1
mille mille sept cent milliards	mille mille sept cents milliards	mais ile di maisil s'ait le cent milliards	1
rassemblant rassurez vous il y en a chez vous	rassurez vous il y en a giroud	rassemblant rassurez-vous il y en a chez vous	0
et c' est la raison pour laquelle j' ai mis ce	euh c' est la raison pour laquelle j' ai misse euh	c' est la raison pour laquelle j' ai mis	0
parce qu' il y avait de la confiance et de l' amitié et quand on se retourne sur cette période	est ce qu' il y avait de la confiance et de l' amitié et quand on se retourne sur cette période	parce qu' il y avait de la confiance c et de l'amidié et quand on se retourne sur cette période	1
elle pourrait rentrer dans un gouvernement ps	elle e en va en tre e dans e n cout e e en le en les e es pa	elle pourrait rentrer dans un gouvernement pé esse ma	0
de sa grand mère ça c' est vraiment c' est c' était ses mots	de sa grand-mère ça c' est vraiment c'est c' était ces mots	de sa grand-mère ça c' est vraiment c' est c était ces mots	1
tel était le mot d' ordre pour les six mousquetaires de l' ump hier soir à provins	tel a été le mot d' ordre pour les six mousquetaires de l' ump hier soir à provin	tel était le mot d' ordre pour les six mousceteires de l' ump hier soir à provin	1
donc vous voyez que la politique fiscale du gouvernement que les écologistes tousenon soutenons totalement	donc vous voyez que la politique fiscale du gouvernement que les écologistes tout ce noubre soutenonc totalement	donc vous voyez que la politique fiscale du gouvernement que les écologistes nou se nons soutenons totalement	0
par l' armée	l' armée	par euh l' armée	0
deux tiers de page pour toi un tiers pour hollande le seul à pouvoir gagner	deux tirs de opage pourtoi un tir pour euh en europe de se la ve ra galiè	deuxième dopage pourquoi un tiers pour eux important que monsieur grand galière	0
et tous deux vous êtes membres de l' association les amis de nicolas sarkozy	et tous deux vous êtes mon de l' association des amis nicolas sark	et tous deux vous êtes membres de l' association des amis nicolas sarkozy	0
et les statuts doivent	il t les statuts de	et les statues de	0
c' est comme ça que vous le voyez	c' est comme ça que vous le voyez euh	comme ça vous le voyez euh	1
il fait comme ns ns	il fait comme une s n	domenech	1
à jacques chirac qui peut être vous en souvenez vous en quatre vingt un	jacques chirac qui peut est vous en souvenez vous en quatre vingt un	à jacques chicarac qui peut-être vous en souvenez-vous en quatre-vingt un	0
très rapidement comme ça guillaume vous voyez un jour bayrou rejoindre hollande là avant deux mille dix sept	euhl( très rapidement comme ça eux guillaume vous voyez un jour bayrou rejoindre euh hollande l' avant deux milles dix-sept	euh très rapidement comme ça euh guillaume vous voyez un jour bayrou rejoindre euh hollande la avan deux milles dix-sept	0
on croit encore aux jeux olympiques	pas encore euh aux jeux olympiques	quoi encore euh aux jeux olympiques	0
le syndicat national des pilotes doit voter l' adoption de cet accord d' ici la mi août	le syndicat national des pilotes doit voter l' adoption de cet accord d' ici la mi-août	le syndicat national des pilotes doit voter l' adoption de cet accord d' ici la mi- août	1
possible l' agence moody' s a placé hier soir ces pays sous perspectives négatives	possible l' agence moodiz a placé hier soir ses pays sous perspective négative	possible l' agence moodi' s a placé hier soir ces pays sous perspective négative	0
alors ronald du côté de l' organisation y a il y a t il encore quelques points noirs à régler	euh ren aldes du côté de l' organisation y a y a-t-il encore quelques points noirs à régler	euh ronald du côté de l' organisation il y a y a-t-il encore quelques points noirs à régler	0
pas encore je me le réserve pour ce week end	pas encore je me réserve pour ce week-end	pas encore je vou le réserve pour ce week-end	1
il y a répondu personnellement et et on a continué à lui faire parvenir ce courrier	il y a répondu de personnellement euh et on a continué à nous faire parvenir chez pourrière	il y a répondu que personnellement euh et et on a continué à lui faire parvenir se ou pourriez être	0
voilà bon week end dans l' immédiat et à très bientôt	bon week end dans l' immédiat et à très bientôt	voilà euh bon week-end dans l' immédiat et a très bientôt	0
l' info trafic avec green accres point com moteur de recherches immobilières sur internet	l' info trafiqu avec grinag point com moteur de recherche immobilière sur internet	l' info trafic avec grinac point com moteur de recherches immobilières sur internet	0
et manifestement en l' état nous ne sommes pas audible	manifestement en l' état nous ne sommes pas audibles	et manifestement en l' état nous ne sommes pas au(	1
après la remontée de nicolas sarkozy au moment de l' affaire merah	euh après la remontée de nicolas sarkozy au moment de l' a fermera	euh après la remontée de nicolas sarkozy au moment de l' affermera	0
si jean luc mélenchon n' est pas le le troisième homme dimanche est ce que ce sera une déception	si jean-luc mélenchon euh n' est pas le le troisième homme dimanche est-ce que ce seraait une déception	jean luc mélenchon n' est pas le le troisième homme dimanche et que ce serait une déception	1
levez vous s' il vous plaît et puis enfin laurent neumann pour marianne bonjour	levnez-vous s' il vous plaît et puis enfin laurent neumann pour marianne bonjour	levezvous s' il vous plaît et puis enfin laurent neumann pour marianne bonjour	0
alors il tient la corde assure un cadre de la campagne l' intéressé bien sûr	il tient la corde assure un cadre de la campagne l' intéressé bien sûr	alors il tient la ccorde a sur un cadre de la campagne l' intéressé bien sûr	1
ce matin nous avons roger moore en séance de dédicace sur les champs elysées	ce matin nous avons roger mour en séance de délicace sur les champs-elysiées)	ce matin nous avons roger mour en séange de délucace sur les champs-elises	1
demain mais pourquoi cette initiative	(emin mais pourquoi cetteuh initiative	demain mais pourquoi cette euh initiative	0
d' ailleurs ils viennent d' annoncer leur participation mercredi à un concert en faveur des victimes de l' ouragan sandy	d' ailleurs ils viennent d' annoncer leur participation mercredi un concert en faveur des victimes de l' ouragan son dis	d' ailleurs ils viennent d' annoncer leur participation mercredi un concert et faveur des victimes de haut un consensus	1
mais c' est vos	mais c' est veau(	mais c' est vous	1
un double qui fait la fiereté de la chanteuse à un détail près	un double qui fait la fierté de la chanteuse àh en de tayreès	un double qui fait la fierté de la chanteuse a ein de teuil près	0
et aussi parce dit elle elle était jolie françois hollande possède un nom un niveau correct tout comme françois bayrou	et aussi parce que dit-elle elle était jolie françois hollande possète un un un niveau correct tout comme françois bayrou	aussi parce que dit elle elle était jolie françois hollande possède un an un niveau correct tout comme françois bayrou	1
mais est ce que ces entreprises françaises comme cosmos savaient comment le régime utilisait leur martel leur matériel	et mais est-ce que ces entreprises françaises comme cosmose savaient euh comment le régime utilisait laur marté(ri() leur matériel	ai mais est-ce que ces entreprises françaises comme euh causmose savaient euh comment le régime utilisait leur marté leur matériel	0
mais pour les autres catégories de personnel cette prime est choquante	mais pour les autres catégories de personnelles cette prime échoquante	mais pour les autres catégories de personnels cette prime est choquante	0
et mais en tout cas sur les cinq boxeurs engagés il y a deux boxeurs qui ont beaucoup d' expérience	et mais en tout cas euh sur les cinq boxeurs engagés il y a deux boxeurs qui ont beaucoup d' expériences	et mais en tout caseuh sur les cinq boxeurs engagés il y a deux boxeurs qui ont beaucoup d' expériences	1
mais franchement vous	fin du mois	un naufragoi	0.5
et cette affaire date de de la fin deux mille onze	et cette affaire date de de la fin deux milles onze	ui cette affaire date de de la fin deux milles onze	1
un mot sympa pour tout le monde	ah bon sympa pour tout le monde	ah mon sympa pour tout le monde	0
le régime syrien a atteint un niveau extrême de cruauté de meurtre	le régime syrien a atteint un niveau extrême de cruauté demeure	(en)fin le régime syrien a atteint un niveau extrême de cruauté fin de meurtre	0
hollande a eu du mal à démarrer si je puis dire et après on n' a pas pu l' arrêter	euh hollande a eu du mal à démarrer si je puis dire et après i() on ' a pas pu l' arrêter	euh hollande a eu du mal à démarrer si je puis dire et après i() on a pas pu l' arrêter	0
mais c' est vos	c' est beau	mais s'is vous	0
dans cette période de crise	euh dans cette période de crise	dans ces périodes de crise	1
elle me paraît judicieuse attendons que monsieur gallois remette	elle me paraît judicieuse attendons que monsieur gallois aurmetre son rapport	elle me paraît judicieuse attendons que monsieur gaillois remettre son rapport	0
mais est ce que vous savez combien coûte par exemple la baisse de la tva sur la restauration	mais est-ce que vous savez combien de coûte par exemple la baisse de la tva sur la restauration	ce que vous savez combien coûte par exemple la baisse de la tva sur la restauration	1
ciné richard gere le retour dans arbitrage philippe dufreigne	sidnéy richargir de retour dans arbitrage philippe dufreigne	siée richard gen retour dans arbitrage philippe dufreigne	0
je préviens le bourget pour leur dire qu' on risque de décoller en retard	je crois quand même un projet pour leur dire qu' on risque de d	près d' un projet pour leur dire qu' on risque de découverte	0
couacs quand enfin vous pouvez pas dire	quoi quand a a vous pouvez pas dire	quoi quand je je pouvais pas dire	1
henri emmanuelli dire que on va devoir travailler plus tard	henri emmanuelli euh dire que on va devoirler plus tard au dé( c' est	henri emmanuelli euh dire que on va travailler plus tard au débat c' est-à-dire que	0
mais ce coup de sécateur était imbécile	mais ce coup de setateur était	mais ce coup de ces qa teurs était un	1
rapport de la cour des comptes il y a aucun doute si c' est cinq cents milliards	de la cour des comptes il y a aucun doute si c' est cinq cents mille	rapport de la cour des comptes il y a aucun doute si c' est sinpon mière	0.5
mais est ce que vous savez combien coûte par exemple la baisse de la tva sur la restauration	ce que vous savez combien coûte par exemple la baisse de la tva sur la restauration	mais est-ce que vous savez combien de coûte par exemple la baisse de la tva sur la restauration	0
rassemblant des personnalités politiques magistrats policiers journalistes intellectuels et même mes chers collègues et même des parents de victimes	rassemblant des personnalités politiques magistrat policiers journalistes intellectuels et même mes chers collègues et même des parents de victimes	rassemblant des personnalités politiques magistrat policiers journalistes intellectuelles et même mes chers collègues et même des parents de victimes	1
on on on s' est on on on le voit il y a des études extrêmement poussées qui montrent	euh on on on s' est on on on le voit y a des études extrêmement poussées qui montrent	euh on on on s' est on on on le voit il y a des études extrêmement poussées qui montrent	0
c' est à paris	c' est appari	est à paris	0
ce coup de sécateur était totalement imbécile	ce coup de ces quor était totalement imbécile	ce coup de se cateurs était totalement imbécile	0
ça fait plaisir	l' effort	ça fait plaisir moi	0
c' est une grande époque qui est de retour on va dire	c' est une grande époque qui est de retour on va bien	une grande époque qui est de retour	1
c' est bien c' est bien c' est un tube ça	eh bien c' est à dire ça ça	sit bien je vais vie c es ça je sens tube ça	0
la droite dit c' est le prix du travail c' est le prix bien	vendredi c' est le prix du travail c' est le bien	un droit de dit c' est le prix du travail c' est le pi bien	0
qu' entre temps le fameux observatoire a changé	qu' entre temps le fameux observateur a changé	temps de le fameux observe tant a changé	1
coûtent les dépenses de santé chaque année il y aura des objectifs de dépenses qui seront fixés chaque année	coûte les dépenses de santé chaque année il y aura des objectifs de dépenses euh qui seront fixés chaque année	les dépenses de santé chaque année il y aura des objectifs de dépenses qui seront fixés chaque année	1
elle sera partie dans les sables comme d' autres avant elle	sera parti dont les sable comme d' autres avant elle	sera partie dans les sables comme d' autres avant elles	0
interdiction également de poster les résultats d' une compétition ou encore de partager les vidéos	interdiction également de poster les résultats d' une compétition ou encore de partager les vidéo	interdiction également de poster les résultats d' une compétition ou encore de partager des vidéos	1
c' est c' est un modèle pour les femmes	aase un c' est un modèle pour les femmes	et ça c' est un modèle pour les femmes	0
un univers foisonnant que les parisiens pourront découvrir à partir de mercredi et bonne nouvelle c' est gratuit	un univers wason que les parisiens pourront découvrir à partir de mercredi et bonne nouvelle s' est gratuée	univers foisonnant que les parisiens pourront découvrir à partir de mercredi bonne nouvelle c' est gratuit	0
a su résister à l' agressivité qui était celle régulièrement de nicolas sarkozy	euh a su euh résister à l' agressivité qui était celle régulièrement eu de nicolas sarkozy	euh a su euh résister à l' agressivité qui était celle régulièrement de nicolas sarkozy	0
tous ceux qui critiquent extrêmement facilement j' ai envie de leur dire faites en le quart	tout ce qui écritie extrêmement facilement j' envius de vois dire faites dans le cas	ceux qui critiquent extrêmement facilement j' ai envie de vous faites dans le cas	0
il voulait recevoir madame laborie il m' a assuré qu' il n' en aurait pas pour plus de dix minutes	et je voulais recevoir madame la bourrivouma assurer qu' il en aurait pas pour plus de dix minutes	il voulais recevoir madame nabouri il m'a assurér qu' il en aurait pas impor plus de diminute	0
ce à quoi l' assemblée nationale est invitée cet après midi c' est à dire	ce à quoi l' assemblée nationale est invitée cet après-midi c cet est-à-dire	ce à quoi l' assemblée nationale est invitée cet après-midi c' est-à-dire	0
vient du ministre des affaires européennes lui même	(béin du ministre des affaires européen lue	()) du ministre des affaires européennes lui-même	0
alors parlons un peu gros sous parce que on peut pas s' empêcher de regarder quand même la facture annoncée	alors parlons un peu grossou parce que on peut pas s' empêcher de regarder quand même la facture annoncée	alors parlons un peu gros sou parce que on peut pas s' empêcher de regarder quand même la facture annoncée	0
le peuple de france	pas de france	y a pas peu de france	0
écologiste au sénat jean vincent placé sera mon invité ce soir	écologiste au sénat j' en va s' emplacer sera mon invité ce soir	écologiste au sénat j' on va s' en placer sera mon invité ce soir	1
ce soit rendu possible avec	se resoit rendue possible aveceuh	se() soit rendue possible avec euh	0
mario draghi considère que cette irréversibilité	et o dragui considèren que cette irréversibilité	il y audra qui considère que euh cette irréversibilité	1
ce ce cette manière de le gommer est en fait absolument énorme	euhh ce ce cette manière de le gommer est en fait euh absolument énorme	euh absolument énorme	1
oui mais l' association des amis de nicolas sarkozy qui est non mais attendez l' association	oui mais de l' association des alnens e s colas sar o i qui e e o po e e e e e e e o on en e e e e e e sociatie)	oui mais l' association des amis de nicolas sarkozy qui est se pose une question' attdez'o	0
il faut surtout pas qu' on reste borné fermé accroché à un certain nombre de choses il faut faire évoluer	faut surtout pas qu' on reste borné fermer euh accrocher un certain nombre de choses il faut faire évoluer	il faut surtout pas qu' on reste e borné fermé euh accrocher un certain nombre de choses il faut faire évoluer	1
focalisent sur certains actes	focalise sur certains actes	kalisz sur certains actes	1
je vous dis de tirer nom de dieu	vous les piele dans le du	vous dit pire et lon de glu	0
et c' est là	et c' est la	euh cela	1
et mais en tout cas sur les cinq boxeurs engagés il y a deux boxeurs qui ont beaucoup d' expérience	et mais en tout caseuh sur les cinq boxeurs engagés il y a deux boxeurs qui ont beaucoup d' expériences	et mais en tout cas euh sur les cinq boxeurs engagés il y a deux boxeurs qui ont beaucoup d' expériences	0
ils me l' ont dit	t ills me l' ont dit	le melon	1
ensuite est ce qu' il va pouvoir violer son caractère profond	ensuite est-ce qu' i(l va pouvoir euh eu violer son caractère profond	ensuite est-ce qu i va pouvoir euh eh violer son caractère profond	1
là en plus il fait des il fait des sorties qui sont pas genre rassembleuse	là en plus i(l) fait des i(l) fait des sorties qui sont pas euh gen(s rassembleuses euh	là en plus i(l) fait des il fait des sorties qui sont pas euh j' en rassembleuses euh	0
pour les français pour ceux qui nous regardent	pour les français pour ceux qui nous reguarden fran çai	pour les français mais ceux qui nous regardent dansaient	1
bien évidemment bien évidemment	bien évide bien évidemment euh	bien évidemment bien évidemment eun	0
hollande a eu du mal à démarrer si je puis dire et après on n' a pas pu l' arrêter	euh hollande a eu du mal à démarrer si je puis dire et après i() on a pas pu l' arrêter	euh hollande a eu du mal à démarrer si je puis dire et après i() on ' a pas pu l' arrêter	1
on s' aperçoit que c' était une action utile	on s' aperçoit que c' était une action type	s' aperçoit que c' était une action utile	0
nicolas sarkozy en en en voici nicolas	(icolas sarkozy h en ne voi nicolas	(icolas sarkozy eno n() voii nicolas	1
pas étalé dans le dans la presse	pas étallé dans l( dans dans la presse euh	étalée dans le temps dans la presse	1
il est pas encore tombé il il vacille il vacille mais il est pas encore sur le point de tomber	il est pas encore tombé il est il vacille euh il vacil mais il est pas encore venu tombé	il est pas encore tonbé il est il va sil e il va si mais il est pas en coron a d	1
le chiffre était	le cee ou e e	le chiffre de tou les	0
honoré au festival lumière le réalisateur qu' on sait engagé en a profité pour se révolter	au nord-et au festival lumière le réalisateur conseil engagé et on a profité pour se révolter	aurait au festival lumière le réalisateur conseil engagée en a profité pour se révolter	0
qu' elle a pas voulu sombrer dans la démagogie ni dans les promesses faciles ni dans les arguments	qu' elle a pas voulu sombrer dans la démagogie ni dans les promesses faciles euh ni dans les arguments euh	elle a pas voulu sombrer dans la démagogie ni dans les promesses faciles ni dans les arguments	0
ils avaient envie de dire un certain nombre de choses puis après il y a une dynamique de situation oui	j il)s avaient envie de dire un certain nombre de choses t puis après il y a une dynamique s qiasi oui	j i(l)s avaient envie de dire un certain nombre de choses et puis après il y a une dynamique de situation oui	0
ils vont être obligés d' envoyer des sportives aux jeux olympiques et le qatar même	il vont être obligé d' envoyer des sportives euh aux jeux olympiques et le qatar même	vont être obligés d' envoyer des sportives aux jeux olympiques et le qatar même	0
qui sauf erreur n' est pas un sympathisant de l' ump donc	christophe erreur n' est pas un sympathisant de l' ump donc	qui saufferreur n' est pas un sympathisant de l' ump don	0
pas le pas l' avis général	pas le pas la viinie	pas le pas la visionnaire	1
ce soit rendu possible avec	reçoit rendu possible avec	sera) soit rendue possible avec euh	0
d' une façon délibérée	an une façon délibéré	une fa çon délibéréée	0.5
on parle beaucoup aussi bien sûr de laure manaudou	on parle beaucoup aussi bien sûr de l' aure manoudou	on parle beaucoup aussi bien sûr de leur ma	1
pas encore je me le réserve pour ce week end	pas encore je me réserve pour ce week-end	pas encore o i le réserve pour ce week-end	1
enfin que les citoyens allemands que les décideurs allemands n' aient pas le sentiment qu' ils payent là	enfin que les citoyens allemands que les décideurs allemands n' aient pas le sentiment qui payent là euh	enfin que les citoyens allemands que les décideurs allemands n' aient pas le sentiment qu' il payent là euh	0
et ce qu' on a vu c' est que	est ce qu' on a vu c' est que	et euh ce qu' on a vu c' est que	1
et c' est la raison pour laquelle j' ai mis ce	c' est la raison pour laquelle j' ai mis	euh c' est la raison pour laquelle j' ai misse euh	1
ce ce cette déclaration tout à fait positive	ce ce cette déclaration euh tout à fait positive	cette déclaration tout à fait positive	0
images signées pierre lascar et thibault le floch les derniers sondages se suivent et se ressemblent	imag sinée pierre lascar et thibault le floch les derniers sondages se suivent et se ressemblent	image signée pierre lascar et thibauld le floc les derniers sondages se suivent et se ressemblent	0
soit on s' écoute à tour de rôle soit on se coupe la parole	c' est que vous êtes un tour de rôle je pense coupe la parole	suoi on s' écoute un tour de rôle j soit on se coupe la parole	0
et non d' une idéologie partisane ou syndicale	et non d' une idéologie partisane au syndicale	et non d' une idéologie partisane au syndical	1
l' analyse que vous en faites et les conséquences que le gouvernement français compte en tirer	l' analyse que vous en faites est les conséquences que le gouvernement français compte en tirer	analyse que vous en faites et les conséquences que le gouvernement français compte en tirer	0
aussi les collectivités la csg ne touche que les ménages que les français qui travaillent ou qui sont retraités	aussi les collectivités la cgt ne touche que les ménages que les français qui travaillent ou qui sont retraités	si les collectivités la csg ne touche que les ménages que les français qui travaillent ou qui sont retraités	1
il y en a trois qui sont célibataires	euh il y en a trois pas qui sont célibataires	il y en a trois ans célibataire	1
donc vous validez donc la décision de créer des mouvements	vous valider donc la la décision de créer des mouvements	donc vous voyez euh donc la la décision euh de de créer des mouvements	1
une lutte qui semble impossible car l' italie de stefano sollima est une italie en pleine crise morale	une lutte qui semble impossible car l' italie de stéphane o solima est une italie en cleine crise morale	une lutte qui semble impossible carlitali de stéphane o solima et tunitalie en cleine crise morale	1
je ne berce pas mon public par des belles paroles rassurantes	je n' abpère que c' est pas moi public par des belles paroles rassurantes	je n' perséma mon public par des belles paroles rassurantes	0
le le rapport de force si j' ose dire au au sénat	euh le le rapport de force si j' ose dire au au sénat	euh le le rapport de force si j' ose dire au sénat	0
dimanche soir dufreigne philippe	dimanche soir' une ça	dimanche soire an t e	1
culture et vous on va parler des oscars avec glenn close habillée en monsieur	culture et vous on va parler des oscars avec gleine clalo habilant monsieur	culture et vous on va parler des oscars avec glaine close ha billan monsieur	0
nicolas sarkozy en en en voici nicolas	(icolas sarkozy eno n() voii nicolas	(icolas sarkozy h en ne voi nicolas	0
vous faites le lien avec l' affaire breivik c' est ça	je veux dire avec l' affaire breivik c' est ça	avec le lien avec l' affaire brevi c' est ça	1
un excès de testostérone risque de stériliser le débat des idées dans cette campagne et ça serait vraiment dommage	excet e stosteron risque de stériliser le débat des idées dans cette campagne ce serait vraiment dommage	excès testoterron risque de stériliser le débat des idées dans cette campagne ce serait vraiment dommage	0
le spectacle salut les copains qui est prolongé	le spectacle salue les copains qui est prolongé	le spectacle salut des copains qui est prolongé	0
le groupe air france klm est en restructuration et vise deux milliards d' économies d' ici deux mille quinze	le groupe air franceklm est en restructuration et vise deux milliards d' économies d' ici deux milles quinze	le groupe air france-klm est en restructuration et vise deux milliards d' économies d' ici deux milles quinze	0
tenu des porté des calomnies inadmissibles sur une de ses adversaires	euh tenue euh des porter des calomnies inadmissibles sur euh une de ses adversaires	tenu des porter des calomnies inadmissible sur une de ses adversaires	0
le chiffre était	le chef fout de e	le chez côté	0
la mort de jean jé colonna qui était le parrain de la corse du sud il y a	euh la mort de janger colonna qui était le parrain de la corse du sud y a	la mort de jean-jicques colonna qui était le parrain de la corse du sud il y a	0
taubira garde des sceaux ministre de la justice	(aut bira garde des sceaux ministre de la justice	obira garde des sceaux ministre de la justice	0
parle déjà à l' oreillette en me disant non pas plus allez y	parle déjà l' oriente en disant on n' en pas plus allez-y	parle déjà à l' horeillette en me disant non pas plus allez-y	0
moi ce que je vous propose c' est que on ait un bref un bref tour	ce que je vous propose c' est que on est un bref euh un breftour	ce que je vous propose c' est que on est un bref euh à bref tour	1
mais qui risque demain d' avoir des difficultés pour l' entreprise ou autre	mais qui risque demain d' avoir des difficultés pour l' entreprise de haute	mais qui risque demain d' avoir des difficultés pour l' entreprise haut	1
alors jean marie le guen	alors-marie le guen	jean marie le bouche	1
mais le financement de la dépendance parce qu' aujourd'hui la	mais le financement de la dépendance parce qu aujourd' hui la	mais le financement de l' indépendance parce que aujo	1
j' apprends tellement de choses catherine avec vous je vous regarde	j' apprends tellement de choses que j ril avec vo vou dete garde	je aprends tellement de choses que le vile avec vos vo vête garde	1
est ce qu' il y a une inspiration dans cette politique guillaume	pa rce qu' il y a une inspiration dans cette politique guillaume	parce qu' il y a une inspiration dans cette politique guillaume	0
pas étalé dans le dans la presse	étalée dans le temps dans la presse	pas étallé dans l( dans dans la presse euh	0
bien évidemment bien évidemment	y a évidemment bien évidemment	bien évidemment bien évidemment euh	0
l' intervention à venir	euh intervention à venir	euh intervention on veute dire	1
pourquoi c' est quoi le tien	pourquoi c' est quoi le tient	pourquoi c' est quoi altia	1
oui vous êtes assez non vous êtes	oui vous les aiz as' est non écoutez	non	1
mais franchement vous	on mais franchement	un meuffrage oumeur	1
oui il est jeune il est il	oui il est jeune il estil	oui il est jeune et il	1
et c' est là	eh c' est là	et cela	1
tout même si y en avait sur les	tout mois mas sine a e sor es entai	tout mai mai si l y a e sur les	0
manuel valls il y pense par exemple pour	manuel vall ça ne di pense par exemple eonpou	manuel valls l' y pense par exemple pour	0
pourquoi d' ailleurs	tout coi d' ailleurs	tout va d' ailleurs	1
ciné richard gere le retour dans arbitrage philippe dufreigne	siée richard gen retour dans arbitrage philippe dufreigne	sidnéy richargir de retour dans arbitrage philippe dufreigne	1
box office ko	box ofuc chaos	boxophioscao	1
c' est une grande époque qui est de retour on va dire	une grande époque qui est de retour	c' est une grande époque qui est de retour on va bien	0
donc vous validez donc la décision de créer des mouvements	donc vous validez euh donc la la décision euh de de créer des mouvements	donc vous voyez euh donc la la décision euh de de créer des mouvements	1
box office ko	boxophioscao	voque sophio chaos	1
le le début de centres nucléaires militaires	le le le début de centres nuclé militaires	le le le début deux centres nucléaires militaires	0
ces vingt septième jeux olympiques la france ce soir sera représentée par le premier ministre jean marc ayrault	ces vingt-septièmes jeux olympiques la france ce soir sera représentée par le premier ministre jean-marc ayrault	ces vingt septième jeux olympiques la france soir sera représentée par le premier ministre jean marc ayrault	1
alors parlons un peu gros sous parce que on peut pas s' empêcher de regarder quand même la facture annoncée	alors parlons un peu gros sou parce que on peut pas s' empêcher de regarder quand même la facture annoncée	alors parlons un peu grossou parce que on peut pas s' empêcher de regarder quand même la facture annoncée	1
se bouffent le nez sur place	euh se bouff le nez sur place euh	euh se boufe le nez sur place euh	0
une nouvelle expo tim burton	nouvelle expo tim	au nouvel expo ting burton oui	1
au dernier étage de l' olympia il a regardé le parterre il y avait tout le gratin du paf	au dernier étage de l' olympia il a regardé par terre il y avait tout le gratin du paf	au dernier étage de l' olympia il a regardé euh le parterre il y avait tout le gratin du pape	1
deux styles deux ambiances mais une même idée réussir une démonstration de force jean baptiste daoulas	deux styles deux ambiances mais une même idée réussir une démonstration de force jean-baptiste nagoulaz	de style deux ambiances mais une même idée réussir une démonstration de force jean-baptiste daoulas	0.5
et nous c' est pareil on est pas heureux et eux non plus on doit vraiment trouver une solution	et nous c' est pareil on n est pas heureux et eux non plus on doit vraiment trouver une solution	mais nous c' est pareil o e pas eureu e e eu non puse oo e o e trè o o oe ma oe nous do e re non trouver une solution no o o noo pas o o n pao	1
annick lepetit bonjour	anicuk lepetit bonjour	anniquke lebotit bonjour	1
une nouvelle expo tim burton	nouvelle expo team	au nouvel expo ting burtom	0
patrick bloche on vous l' avait promis vous venez de l' avoir merci grand merci à tous les deux	(tricqu brofh on vous l' avez promis vous venez de l' avoir merci grand merci à tous les deux	quand vous l' avez promis vous venez de la voir merci grand merci à tous les deux	1
et nous c' est pareil on est pas heureux et eux non plus on doit vraiment trouver une solution	et nous c' est pareil ils sont pas heureux et eux non plus on doit vraiment trouver une solution	mais nous c' est pareil o e pas eureu e e eu non puse oo e o e trè o o oe ma oe nous do e re non trouver une solution no o o noo pas o o n pao	1
le nouveau président ne composait pas un gouvernement il recrutait dit elle pour un casting	le nouveau président ne composait pas un gouvernement il recrutait dit-elle pour un casting	le nouveau président ne composait pas un gouvernement il le recrutait dit-elle pour un casting	1
dans le quinquennat précédent donc vous voyez	le quinquennat précédent dont vous voyez	dans le quinquennait euh précédent donc vous voyez euh	0
à peine installé le gouvernement a commandé un rapport qui a confirmé la viabilité et la rentabilité du site	à peine installlé le gouvernement a commandé un rapport qui a confirmé la viabilité et la rentabilité du site	a peine installé le gouvernement a commandé un rapport qui a confirmé la viabilité et la rentabilité du site	1
sur un certain nombre de labels ofg que vous connaissez mais également le label entreprise du patrimoine vivant	euh sur un certain nombre de labels ofg que vous connaissez mais également euh le label entreprise du patrimoine vivant	sur un certain nombre de label ou que vous connaissez mais également le label entreprise du patrimoine vivant	1
peu m' importe parce que l' institut montaigne qui est un institut patronal	peu m' importe parce que euh l' institut montaigne qui est un institut patronal euh	importe parce que l' institut montaigne qui était un institut patronal	1
priorité nous sommes nous sommes	priori ça ne vous allez en choisissant m	priorité nous sommesan nous sommes	0
donc vous voyez que la politique fiscale du gouvernement que les écologistes tousenon soutenons totalement	donc vous voyez que la politique fiscale du gouvernement que les écologistes tous seront soutenons totalement	donc vous voyez que la politique fiscale du gouvernement que les écologistes tou se nou) soutenons totalement	1
elle me paraît judicieuse attendons que monsieur gallois remette	me paraît judicieuse attendant monsieur gallois remet son rapport	elle me paraît judicieuse attendons que monsieur gallois remette son rapport	0
mais est ce que vous pouvez chiffrer ces moyens qui auraient été mal utilisés selon vous	mais est-ce que vous pouvez euh chiffrer ces moyens qui auraient été euh mal utilisés selon vous	mais est-ce que vous pouvez euh chiffrer ses moyens qui auraient été euh mal utilisés selon vous	1
temps de diminuer la flotte d' avions moyens courriers d' air france	tenpt de diminuer euh la flotte d' avion moyen courrier d' air france euh	tent de diminuer euh la flotte d' avion u moyen courrier d' air france euh	1
mais le financement de la dépendance parce qu' aujourd'hui la	mais le financement de l' indépendance parce que aujo	mais le financement de la dépendance parce qu aujourd' hui la	0
on voit dans les rues il y a de plus en plus de monde	voit dans les rues il y a de plus en plus de monde	on le voit dans les rues il y a de plus en plus de monde	0
repartons à londres retrouver notre consultant en boxe c' est un médaillé d' or messieurs brahim asloum bonsoir brahim	repartons à londres retrouver notre consultant box c' est un médaillé d' or messieurs brahim asloum bonsoir brahim	repartons à londres retrouver euh notre consultant boxe c' est un médaillé d' or messieurs brahime asloum bonsoir brahim	1
alors j' ai entendu un peu la démagogie sur les collectivités vous savez sur les	alors j' ai entendu un peu la démagogie sur les collectivités vous savez sur les euh	alors j' ai entendu un peu la démagogie sur les collectivités u vovez sur les euh	1
possible l' agence moody' s a placé hier soir ces pays sous perspectives négatives	possible l' agence m moj s a placé hier soir ces pays sous perspective négative	possible l' agence moodiz a placé hier soir ses pays sous perspective négative	0
ça n' a rien à voir c' est des histoires de contrat du service public	e vai ren avoir c' es l'ide e e e e on e e a du servi e e e pu lii	ça n' avait rien à voir c' est l' idée au compteur a du service public	0
parle déjà à l' oreillette en me disant non pas plus allez y	parle déjà à l' aurreytte en me disant non pas plus allez-y	déjà l' oreillette en me disant non pas plus allez y	1
parce que juifs ou parce que chrétiens peu importe	parce que juifs ou parce que les chrétiens pimpante	parce qu est juif ou parce qu' est chrétien peu importe	0
les grandes entreprises ont beaucoup bénéficié et nous évidemment la gauche les écologistes voulons revenir là dessus	les grandes entreprises ont beaucoup bénéficié et nous évidemment la gauche les écologistes nous voulons revenir là-dessus	les grandes entreprises ont beaucoup bénéficié et nous évidemment la gauche ou les écologistes voulons revenir là dessus	1
le président de la république est nouvellement élu il dit je vais réduire la dépense de dix milliards rappelez vous	président la république et nouvellement élue je vais réduire la dépense dix milliards rappelez vous	président de la république est nouvellement élu il dit je vais réduire la dépense dix milles rappelez-vous	1
monsieur qu' elle était le	monsieur v u quaritéz de	pasu qu' elle était là	0
nous sommes trois à nous départager	nous sommes trois à nous déparceler	sommes trois à nous départ c' est vrai	1
qui existait de basculer le montant non utilisé du crédit collaborateur sur l' irfm sera supprimée	qui existait de basculer le montant non utilisé du crédit collaborateur sur l' irfm sera supprimé	qui existait de basculer le montant non utilisé du crédit collaborateur sur l' irfm sera supprémé	1
c' est vrai que il manque sur le soutien il y a besoin d' une écologie forte	c' est vrai que il manque sur le soutien il y a besoin d' une écologie fort	euh c' est vrai que il manque sur le soutien il y a besoin d' une écologie forte	0
mais qui est français	iquée français	mais qui es français	0
dix huit heures trente après	dix-huit heures trene après	dix-huit heures et trent inte mintee après	1
un double qui fait la fiereté de la chanteuse à un détail près	un double qui fait la fierté de la chanteuse àh en de tayreès	un double qui fait la fierté de la chanteuse à un de deuil près	0
et manifestement en l' état nous ne sommes pas audible	et manifestement en l' état nous ne sommes pas au(	manifestement en l' état nous ne sommes pas audible	0
mais ce coup de sécateur était imbécile	mais ce coups de ces cateurs était in	et ce coup de séquateur était	0
voilà bon week end dans l' immédiat et à très bientôt	voilà euh bon week-end dans l' immédiat et à très bientôt	voilà euh bon week-end dans l' immédiat et a très bientôt	1
dit maintenant ok je mets je remets les pendules à l' heure et c' est nécessaire	dit maintenant auquel je mets je remets les pendules à leur et c' est nécessaire	duit maintenant ok je mets je remets les pendules à l' heur et c' était nécessaire	0
la zone euro va s' effondrer et on va ressembler à la grèce ou à l' espagne	un zone euro va s' effondrer on va sembler agresser l' espagne	la zone euro va s' effondrer on va ressembler à la gresse ou à l' espagne	0
écologiste au sénat jean vincent placé sera mon invité ce soir	écologiste au sénat j' on va s' en placer sera mon invité ce soir	écologiste au séna jean vasent passe sera mon invité ce soir	0.5
culture et vous on va parler des oscars avec glenn close habillée en monsieur	culture et vous on va parler des oscars avec glaine close ha billan monsieur	culture et vous on va parler des oscars avec gleine clalo habilant monsieur	1
qui boxeraient le lendemain ou qui auront une compétition le le lendemain	qui boxeraient le lendemain ou qui auront une compétition euh le le lendemain	qui boxeraient le lendemain ou qui auront une compétition le le le lendemain	1
davantage au cortex qu' aux tripes	davantage au ctexteco trique	davantage au corps texcotrique	0
et aussi parce dit elle elle était jolie françois hollande possède un nom un niveau correct tout comme françois bayrou	et aussi parce que dit-elle elle était jolie françois hollande possède un un an un niveau correct tout comme françois bayrou	et aussi parce que dit-elle elle était jolie françois hollande possède un un an un niveau correct ou comme françois bayrou	1
mais oui ça sort aujourd'hui stars quatre vingt un film avec	maihs oui ça sort aujourd' hui star quatre-vingt un film avec	eh oui ça sort aujourd' hui star quatre-vingt un film avec	0
un mur qui ressemble à une véritable liste noire futur tableau de chasse du syndicat de la magistrature	mur qui ressemble à une véritable liste noire futur tableau de chasse du syndicat de la magistrature	un mur qui ressemble à une véritable liste noire future tableau de chasse du syndicat de la magistrature	0
qu' entre temps le fameux observatoire a changé	temps de le fameux observe tant a changé	qu' entre temps le fameux observateur a changé	0
c' est c' est un modèle pour les femmes	et ça c' est un modèle pour les femmes	c ça c' c' est un modèle pour les femmes	1
la compagnie veut proposer des incitations financières à ses pilotes pour les faire travailler au sein de sa filiale transavia	la compagnie veut euh proposer des incitations financières à ces pilotes pour les faire travailler au sein de sa filiale transavia	la compagnie veut euh proposer des incitations financières à ces pilote pour les faire travailler au sein de sa filiale transavia	1
ce soit rendu possible avec	se() soit rendue possible avec euh	se resoit rendu possible avec euh	1
puis les candidats speak t il english	puis les candidats spictil ing glich	puis les candidats spiquent ylin glich	1
qui était fébrile peu sûr de lui	qui était fébrile peu sûrre de lui	était fébrile peu sûr de lui	1
bonsoir catherine frot	bonsoir catherine fro	bonsoir catherine fraud	1
elle a fait quand même que deux vrais albums	devrait	on je v quand même que deux vrais albums	0
voilà il a reçu sa petit toque françois hollande	voilà il a reçu sa petite toc françois holde	donlà la reçu ça petite toc françois hollande	1
par le passé un certain nombre de boycott d' ailleurs	euh par le passé nun certain nombre de boycott d' ailleurs	euh par le passé un certain nombre de boycott d' ailleurs	0
donc vous voyez que la politique fiscale du gouvernement que les écologistes tousenon soutenons totalement	donc vous voyez que la politique fiscale du gouvernement que les écologistes tous seront soutenons totalement	donc vous voyez que la politique fiscale du gouvernement que les écologistes nou se nons soutenons totalement	0
et je suis d' accord que c' est un peu irritant ce son	suis d' accord que c' est un peu héritant ce sont	oui je suis d' accord que c' est un peu héritant euh ce son	0
nous sommes trois à nous départager	sommes trois à nous départ c' est vrai	nous sommes trois à nous déparceler	0
soit cinquante deux pour cent de notre produit intérieur brut	cinq virgule deux pour cent de notre produit intérieur brut	soit cinq virgule deux pourcent de notre produit intérieur brut	0
elle dit faire illusion non non elle fait réel	elle dit faire illusion non non elle fait réelle	différer le logis en un an elle fait réel	1
et laurent neumann pour marianne bonjour laurent	laurent neumann pour marianne bonjour laurent	et laurent deman pour marianne bonjour laurent	1
de blessures graves pour l' un d' entre eux les conséquences terribles de cet attentat	des blessures graves pour l' un d' entre eux euh euh les conséquences terribles de cet attentat	blessures graves pour l' un d' entre eux euh les conséquences terribles de cet attentat	0
enfin vingt milliards d' impôts et dix milliards d' économies	dix milliards d' économies	vingt vingt milliards d' impôts no et dix milliards d' économie e e pte)	0
elle pourrait rentrer dans un gouvernement ps	elle pourrait rentrer dans un gouvernement du ps pas	elle e en va en tre e dans e n cout e e en le en les e es pa	1
un univers foisonnant que les parisiens pourront découvrir à partir de mercredi et bonne nouvelle c' est gratuit	univers foisonnant que les parisiens pourront découvrir à partir de mercredi bonne nouvelle c' est gratuit	un univers wason que les parisiens pourront découvrir à partir de mercredi et bonne nouvelle s' est gratuée	1
nous nous restreindre à deux virgule cinq deux virgule huit trois pour cent	euh nous nous restreindre à euh de virgule cinq deux virgule huit trois pour cent euh	euh nous nous restreindre à euh de virgule cinq deux virgule huit trois pourcent euh	1
pourtant en coulisses c' est bel et bien l' après présidentielle qui se jouait en seine et marne	pourtant au coulisse c' est bel et bien l' après présidentielle qui se jouait en scèine et marne	pourtant aux coulisses c' est bel et bien l' après présidentielle qui se jouait en seine-et-marne	0
remède ici j' en ai entendu tout à l' heure quelques propositions	rome a d' ici j' en ai entendu tout à l' heure quelques pro pre positions	remède ici j' en ai entendu tout à l' heure quelques pro) propositions	0
bfm tv dix huit heures bonsoir rachid m' barki	bfm tv dix-huit heures bonsoir rachidne barki	bfm tv dix-huit heures bonsoir hachid n barki	0
la compagnie veut proposer des incitations financières à ses pilotes pour les faire travailler au sein de sa filiale transavia	la compagnie veut euh proposer des incitations financières à ses pilotes pour les faire travailler au sein de sa filiale transaviable	la compagnie veut euh proposer les incitations financières à ses pilotes pour les faire travailler au sein de sa filiale transabia	0
et il a sélectionné les les mails les témoignages auxquels il voulait répondre et il a	et il a sélectionné l' ailleurs euh ele est lma telmoigniage ocalie il voulait répondre euh et il a	et il a sérictionné l' est euh euh les mêmes les témoignages auquel il fallait répondre euh et il a	0
assez intense donc on attend vraiment que les jeux commencent	assez intense donc euh on attend vraiment euh que les jeux commencent	c' est intense donc on attend vraiment que les jeux commencent	0
ce soir françois hollande a été conforté dans dans sa stature dans sa capacité à diriger l' état	ce soir françois hollande a été confortée dans dans sa stature en sa capacité à diriger les mains	ce soir françois hollande a été conforté dans dans sa stature euh dans sa capacité à diriger les femmes	1
mille mille sept cent milliards	mais ile di maisil s'ait le cent milliards	mille mille sept cents milliards	0
le le le type de risque et l' échelle des hypothèses en matière de dangerosité est extrême et extrêmement large	le le fait dire et le le le type de risque et l' échelle des hypothèses en matière de dangerosité extrême est extrêmement large	le jd le le type de risque et l' échelle des hypothèses en matière de dangerosité est extrême et extrêmement euh large	0
nous on parle aux français on parle aux électeurs on parle au coeur du peuple militant et justement	nous on parle aux français on parle au on on parle aux électeurs on parle au coeur du peuple militant et justement	on parle aux français par zola je parle aux électeurs on parle au coeur du peuple militant et justement	1
places à vendre	place à vendre	à vendre	1
filet de sécurité maintenu	illies de sécurité maintenue euh	pilet de sécurité maintenu euh	0
l' affairisme les cercles de jeux c' est le cercle wagram à paris	euh l' affairisme les cercles de jeu c' est le cercle vagram à paris	euh l' affairisme les cercles de jeux c' est le cercle vagrame à paris	0
une réunion publique ce matin où il s' est adressé	réunion publique ce matin où il s' est adressé	une réunion publique ce matin où ill s' est adressé	0
soit on s' écoute à tour de rôle soit on se coupe la parole	(fou on s' écoute à tour de rôle je cois on se coupe la parole	ois on s' écoute un tour de rôle je pense coupe la parole	1
mais est ce que ces entreprises françaises comme cosmos savaient comment le régime utilisait leur martel leur matériel	ce que ces entreprises françaises comme kosmos savait comment le régime utiliser leur martèle leur matériel	et 'ai est-ce que ces entreprises françaises comme euh cosmos savaient euh comment le régime utilisait leur marté() leur matériel	0
il y a une résignation alors y a des manifestations mais est ce que y a un plan b	est une résignation alors il y a des manifestations mais à ce que il y a un plan b	il y a une résignation alors il y a des manifestations mais est-ce que il y a un plan bé	0
et nous c' est pareil on est pas heureux et eux non plus on doit vraiment trouver une solution	mais nous c' est pareil o e pas eureu e e eu non puse oo e o e trè o o oe ma oe nous do e re non trouver une solution no o o noo pas o o n pao	et nous c' est pareil on n est pas heureux et eux non plus on doit vraiment trouver une solution	0
rapport de la cour des comptes il y a aucun doute si c' est cinq cents milliards	apport de la cour des comptes il y a aucun doute si c' est cinq cents milliard	rapport de la cour des comptes il y a aucun doute si c' est ça sont mia	1
à sa à sa à sa dimension et et eut égard aux crises que nous lui connaissons	à à sa) à sa à sa dimension et et eu égard aux crises que nous connaissons	à à sa à sa à sa dimension et et eu égard aux crises que nous connaissons	0
remède ici j' en ai entendu tout à l' heure quelques propositions	rema de ici j' en ai entendu tout à l' heure quelque propr position	remède ici j' en ai entendu tout à l' heure quelquesos propositions	0
le donc pas de cravate le le week end prochain	le ne pas de tralat le le week-end prochain	le de pas de cravate le le week-end prochain	0
chercher une surinterprétation au delà de ce simple	chercher une sur-interprétation au-delà de ce simple	chercher une sur interprétation au-delà de ce simple	1
donc vous voyez que la politique fiscale du gouvernement que les écologistes tousenon soutenons totalement	donc vous voyez que la politique fiscale du gouvernement que les écologistes tou se nou) soutenons totalement	donc vous voyez que la politique fiscale du gouvernement que les écologistes tous seront soutenons totalement	0
ce qui ce qui eut été	oui ce qui ce qui eut été	ce qui est ce qui a été	1
l' éventuelle montée en puissance de françois fillon	euh l' éventuelle montée en puissance de françois fillon	euh l' éventuel montée en puissance de françois fillon	1
il fait du vélo dit votre fille	qi fait du vélo de votre fille	du vélo	1
qui existait de basculer le montant non utilisé du crédit collaborateur sur l' irfm sera supprimée	qui existait de basculer le montant non utilisé du crédit collaborateur sur l' rfm sera suprimé	qui existait de basculer le montant non utilisé du crédit collaborateur sur l'fm sera supprimé	1
ça s' améliore	ça ser améliore	ça se es iméliore	1
c' est moins que pékin mais c' est beaucoup plus que tous les les autres jo	et moi que pékin mais c' est beaucoup plus que tous les les autres	c' est moins que pékin mais c' est beaucoup plus que tous les les les autres egons	1
possible l' agence moody' s a placé hier soir ces pays sous perspectives négatives	possible l' agence moodi' s a placé hier soir ces pays sous perspective négative	possible l' agence moodiz a placé hier soir ses pays sous perspective négative	1
tel était le mot d' ordre pour les six mousquetaires de l' ump hier soir à provins	tel était le mot d' ordre pour les six mousquetaires de l' ump hier soir à provin	tel a été le mot d' ordre pour les six mousquetaires de l' ump hier soir à provin	1
à la fois notre programme	euh à la fois notre programmes	euh à la fois nos programmes	1
des éditions hugo et compagnie et puis avec vous avec nous virgile caillet bonsoir vous êtes directeur de kantarsport	d' édition hugo et compagnie et puis avec vous vous avec nous virgines caier bonsoir vous êtes le directeur de quant ar sport	éditions hugo et compagnie et puis avec vous vous avec nous virgiles cailyet bonsoir vous êtes eu directeur de cantarsport	0
parce que tout va aller très vite	parce que tout va arrive très vite	est ce que tout va aller très vite	1
c' est c' est un modèle pour les femmes	c ça c' c' est un modèle pour les femmes	et ça c' est un modèle pour les femmes	0
ses failles et et parfois justement ce que ça pouvait avoir de	ces failles et et parfois justement ce que ça pouvait avoir de mal	euh s' éfaillent et euh et parfois justement ce que ça pouvait avoir de enmer gural	1
ils vont être obligés d' envoyer des sportives aux jeux olympiques et le qatar même	vont être obligés d' envoyer des sportives aux jeux olympiques et le qatar même	il von être obligé d' envoyer des sportives euh aux jeux olympiques et le catard même	1
avec pugnacité marie labat	avec pugnacité marie-labet	avec pugnacité marie laban	1
florence alors à la une des hebdos anne lauvergeon sans état d' âme	flarane le rougi alors à la une des hebdo anne levergeonc sans état d' ame	bougies alors à la une des hebdos anne lauvergeon sans état d' âme	0
je serai candidat à la primaire pour l' élection présidentielle deux mille dix sept	je serai candidat à la primaire pour l' élection présidentielle de deux milles dix-sept	je serai candidat à la primaire pour l' élection présidentielle deux milles dix-sept	0
nous on parle aux français on parle aux électeurs on parle au coeur du peuple militant et justement	on parle aux français par zola je parle aux électeurs on parle au coeur du peuple militant et justement	nous on parle aux français on parle au on on parle aux électeurs on parle au coeur du peuple militant et justement	0
voilà il a reçu sa petit toque françois hollande	oà il a reçu sa petite toc françois hollande	voilà il a reçu sa petite tocue françois hollande	0
trop généreuse pour certains ça c' est une conviction personnelle je sais qu' elle fait l' objet de débats	trop généreux pour certains ça c' est une conviction personnelle je sais qu' elle fait l' objet de débats	trop généreuse pour certains ça c' est une conviction personnelle je sais qu elle fait l' objet de débat	0
elton john toujours très impliqué par la lutte contre le sida	elton john toujours très impliqué dans la lotpe contre le stida	elton john toujours très impliqué dans la lutte contre le sida	0
écologiste au sénat jean vincent placé sera mon invité ce soir	écologiste au sénat g en va s' en placer sera mon invité ce soir	écologiste au sénat jean-vinci placé sera mon invité ce soir	0
c' est nettement moins que pékin ça c' est sûr en revanche c' est	est nettement moins que pékin ça c' est en revanche c' est	c' nettement moins que pékin ça c' est sûr de en revanche c' est	0
à jean françois copé d' avoir justement pris cette initiative	grée à jean-françois copé d' avoir justement pris cette initiative	grét à eanfrançois copé d' avoir justement pris cette initiative	1
moi je veux participer à la construction de cet avenir de l' ump	je veux participer à la construction de cet avenir de l' ump	moi je veux participer à la construction de cet avenir euh de l' ump	0
mais vous dites qu' ils nous ont répondu mais nous on leur a pas parlé	mais vous dites quil nous aut répondu mais nous on leur a pas parlé	mais vous dites qu'il nous an répondu mais nous on leura pas parlé	1
la zone euro va s' effondrer et on va ressembler à la grèce ou à l' espagne	un zone euro va s' effondrer on va sembler agresser l' espagne	la zone euro va s' effondrée e on va ressembler à a grésseou à l' espagne	0
